1111111111111111111111111111111111111111111111111
1000100000000000000000000010001000000000001010001
1110101111111111101111111011101011101111101010101
1000100000100000001000001000100010001000101010101
1011111111101111111010111110101110111010101010101
1010000010001000100010000010100010001010101000101
1010111010111010101111111010111011101011101111101
1010001010001010101000000010100010101000001000001
1011101011101110101011111010111010101110111011101
1000101010001000101010000010001000100010100010001
1110101010111011101011111111101110111010101110111
1000101000100000101000000000100010001010001010101
1011101111101110101111111110111011101011111010101
1000001000101010001000000010100010101010000010001
1111111010101011111111101110101110101010101111101
1000001010101000000000100010001000001010100000001
1010101011101011111010111011111111111010111111111
1010101010001000001010001000001000100010100000001
1010101010111111111011101011101010101110111111101
1010100010000000001010100010100010101000100000001
1010111111111111101010111110111110101011101111101
1010100000000000101010000010000010001000001000001
1010101111101110101010101110101111111111111011111
1010100000101010101010101000100000001000001010001
1010111110101010101010101011111111101010111010101
1010000000101000100010101000100010101010100010101
1111111011101011111110101110101010101010101110101
1000001000101010000010101000101000100010001000101
1011101111101110111010101011101110111111111011101
1000100000001000101000101010000010001010000000101
1010111011111011101111101010111011101010111110101
1010100010001000100000101010100010001000101000101
1010111010101110111010101011101110111011101011111
1010001010100000100010101000001000100000101000001
1011101110111111101011101111111011111110101111101
1000101000100000101010000000001000001000101000001
1110101011101110101110111111111111101011101011101
1010100010000010100010000000100010001010001010001
1010111111101010101011111110101010111011101011111
1010100000101010101000000010001010100000001000001
1010101110111010111011101111111010111110111111101
1010101010100010100010001000000010000010100010001
1010101010101110101111111011111111111010101010101
1000101010101000100000001000100010001010101010101
1011101010101011111011101110101010101011101010111
1000001010101010001010000010001000101000001010001
1111111010101010101110111011111111101111111011101
1000000000001000100000100000000000100000000000001
1111111111111111111111111111111111111111111111111
