111111111111111111111
100010000000100000001
111010101110101111101
101010101000001000101
101010101111111010101
101010100000000010101
101011111011111110111
101000001000100010001
101111101110101111101
100010101000101000001
101010101011101011111
101000101000001000001
101111101110111111101
101000001000100000001
101011111111101111101
101010001000001000001
101010101011111011111
100010101010001010001
101110101010111011101
100000100010000000001
111111111111111111111
