111111111111111111111
101000000010000010001
101011111011101110101
101000101000100000101
101110101110101111101
100010101000100000101
111010101011111111101
101010100000000000101
101010111111111110101
100010000000001010101
101110111111101010101
100010000010001010101
111011111110111010101
100010001000100010001
101110101011101111101
101000100010001000101
101011111111101010101
101000000010001010101
101111111010111010101
100000000010000010001
111111111111111111111
