111111111111111111111
101000000000000000101
101110111111111110101
100010100000001000101
111010101111101011101
100010100000101010001
101110111110111011101
101000000010000010001
101111101011101110111
100000101000100010001
111110111110111011101
100000100000101000101
101111101111101110101
100010001000001000101
111010111011111011101
101010100000000010001
101010101111111110101
100010100010000000101
101110111011111110101
100000100000000000101
111111111111111111111
