111111111111111111111
100010000010000000001
111011111010111110101
100010001000100000101
101110101011101111111
100000101010100010001
111111101010111010101
100010001000101000101
111010111110101111101
100010100000000010001
101010111111111110101
101010000000000000101
101111111111111111101
101000000000100000101
101010111111101110101
100010000010001000101
101111111010111011101
101000000010100010001
101011111110101110111
101000000000100000001
111111111111111111111
