111111111111111111111
100000001000100000001
111111101010101111111
100000101010001000001
101110101011111011101
100010001000000010101
111011111011111010101
100010000010001000101
101111111110101111101
100010000010100010001
111010111010111010101
101000100010001010101
101111101110101010101
100000100010101000101
111110111010101111101
100000100010101000101
101111101111101011101
101000101000001010001
101010101011111010111
100010000010000000001
111111111111111111111
