111111111111111111111
100010000000000000001
111010111111111111101
100010000010000000001
101111111110111111101
100000001000100010001
111111101011111010111
100000100010001010101
101110111110101010101
101000000000101010001
101111111111101011101
100000000010001000101
101111111011101110101
101000001000100000101
101011101110111110101
101010000000100010101
101011111111101011101
101010000010001000101
101010111010111110101
101000001000000010001
111111111111111111111
