1111111111111111111111111111111111111111111111111
1010001000001000000000100000000000000010001000001
1010101011111010111110111110111110111010111010101
1000101000100010100010000010101000101010001010101
1111101010101110101111111010101011101010101010101
1010001010001000101000001010001000100010100010101
1010111110111011101011101010111110101111111110101
1010000010100010001010101010100010100010000010101
1011111011101110111010101011101010111010111010101
1000001010001000001000101000101010101010100000101
1011101010111011101110101110101010101010111111101
1010101010100010001000100010001010101010000010101
1010101010111010101011101111111010101011101010101
1000100010001010101000100000001010101000101010101
1110111111101010111011111110101010101110111010101
1000100000001010100010000000101010100010001010001
1011101111111010101110111111111010101011101011111
1010001010000010001000100010001000101010001000001
1010111010111111111011101010101111111010111111101
1000100010100000001000001000100000000010001000001
1111111010111111101111111111111010111111101011101
1000000010000010000000001010000010100000100010101
1011101111111010111111101010111110101110111110101
1010100000000010001000100010001000101010000000101
1010111111111111101010111011101111101011101111101
1010100000000000001010001000100000101000100000001
1010101110111111111011111011111110101110111111111
1010001000100000000000100010000010100000100010001
1011101011101111111110101110111010111110101011101
1000101010100010000000101000100010001000101000101
1110101010111010111110101011111011101011101110101
1010101010000010100000101000001000001010001000101
1010111011111110111011101111101111101010111011101
1000100010000010001000101010001000101000101000001
1011101110111010101110101010111010111111101111101
1000001000101010101000101010001010001000000000101
1111111010101011101111101011101011101010111110101
1000001010100000001000100010100010100010100000101
1011111010101111111010111010111110111110111111101
1000100010101000100010000010000010000010000000001
1110101110111010101111111111101011111011111111111
1000100010100010001000100000001000000000100000001
1011101110101111111010101110111111111110111110111
1010001000101000001010001010001000000010000010001
1010111011101110101111101011101011111011111011101
1000100010001000100000100010001010000010001000001
1011101110111011111110111110111010111110101111101
1000100000000010000000000000100010000000100000001
1111111111111111111111111111111111111111111111111
