1111111111111111111111111111111111111111111111111
1000101000100000000000001000100000000000000000001
1110101010101111111011101110101111111011111111101
1000101010000000100010000000100000101010001000101
1011101011111111101011111111111110101010101010111
1010000000001000001010000000100010101000100010001
1011111111101011111110111110101010101111111111101
1010000010001000001000100010101010000000100000101
1010111011101111101011111010101011111110101110101
1000101000101000101000001010001000000010100010101
1111101110101110101111101011111111111010111011101
1000001000101000100010101000000010001010001000101
1010111011101010101010101011101010101011101110101
1010000010000010101010101010001000101000000000101
1011111110111111101010101010111111101111111111101
1010100000101000001000101010100000001000000010001
1010101111101011101111101110111110111011111010101
1010101000001000101000001000100010101010001000101
1010101011111110111011111010101010101010101111101
1010000010000010000010000010101010101000100000101
1011111010111011111010101111101010101111111110101
1000101010001000001000101000001010000010000010101
1110101011101111101111101011111011111011101110101
1010101010001000001000001010001000100010001000101
1010101010111011111111111010111110111010101011101
1010100010001000100000000010000010001000101010001
1010101111101110101011111111101011101011111011101
1010101000101000101000100000001000101010001000101
1010111010101110111110101110111111101110101110111
1010100010100010000010101010001000100010100010001
1010101110111011111010101011101010111010111011101
1010001010000010001000100010100010100010100000001
1011111011111110101111111010111110101110111111101
1000000010000010100010000000000010101000000000101
1011111010111010111010111111111110101111111110101
1000001000100010100010100000001000100010000000101
1111101111101110101111101111101010111010111111101
1000101000101000101000001010001010001010001000001
1010101011101011101011111010111011101010101011111
1010001000000010000010000000100010001010101010001
1011111111111111111110111111101011111011101011101
1010000000100010001000100000101010001000001010001
1010111110101010101110111010111010101111111010101
1010100000101010100010000010000010100000000010101
1010101110101010111011111111111110111111111110101
1000101000101010101000001000100000100010000000101
1011101111101010101111101010101111101011101111101
1000100000001000000000100010000000001000001000001
1111111111111111111111111111111111111111111111111
