111111111111111111111
101000000010000000101
101011111011101110101
100010001010001010001
111110111010111011101
100010001000100000101
101011101111101011101
101000000010001010001
101111101110101010111
101000101000101010001
101010111011101111101
100010001010100000101
111111101010111110101
100000101000100010001
101110101110111011111
101000001000100010001
101111101011101011101
100000101010001000001
101110111010111111101
100010000000100000001
111111111111111111111
