111111111111111111111
101000100000100000001
101110101011101110101
100010001000001000101
111011111110111011101
100010000010100010001
101110111010101111111
101000001010100000001
101011101011111111101
101000101000000000001
101110101111111111101
101000101000001000001
101011101011111011111
101010001000100010001
101110111110101110101
100010100010100000101
111010101010111111101
100010001010000010001
101111111010111010111
100000000010001000001
111111111111111111111
