111111111111111111111
101000000000001000001
101011111111101110101
101010000000100010101
101010111011111011101
100010101000001010001
111110101111101010101
100010101000001010101
101010101010111010101
101000001010100010101
101111111010101110101
100000100010101000101
111110101111101011101
101000100000001010101
101011111111111010101
101000100000100010101
101110111010111010101
100010100010001010001
101010101111101010111
101000001000000010001
111111111111111111111
