111111111111111111111
100010000010001000001
111010111010101011101
101010001010100010001
101011101010111110111
100010001010001010001
101110111011101011101
100000100010001000101
111111101110111011101
100000101010100010001
101110101010101010111
101000101010001010001
101111101011111011101
100000001000000000101
101111111111111111101
100000001000000000101
111111101011111110101
100000101010100000101
101011101010101111101
101000000010000000001
111111111111111111111
