111111111111111111111
101000001000000010001
101010101110111110101
101010100010000000101
101110111011101111101
100000101000101000101
111111101110101110101
101000000010100000101
101011101110111110101
100000100010001000101
101111111011101111101
101000000010100000001
111011111010111111101
100010001000100000001
101010101110101111111
101010100010100000001
101110111011111111101
100010101000001000101
101010101111101010101
101000000000100010001
111111111111111111111
