111111111111111111111
101000001000000010001
101110111010111010101
100010100010001010101
111010101111101110101
101010000000101000101
101011111110101011101
100010000010100000101
101110111010111111101
100000101010100010001
111111101010101010111
100000100010001010001
101111101111111011101
101000100010001010001
101010111010101010111
100010100010101010001
101110101110101111101
101000101000100000001
101011101110111111101
101000000000100000001
111111111111111111111
