111111111111111111111
100010000000100000001
111011101110111111101
101000101000100000001
101110101011101111111
100010101000101000001
111010101110101011101
100010101000100000101
101110101110111011101
101000100010001010001
101011101011101110101
101010001010100000101
101011111010111111101
101010000010001000001
101010111110111011111
101010000010100010001
101011111010101111101
101000100010100000001
101110101110111111101
100000001000000000001
111111111111111111111
