111111111111111111111
100000000000001000001
111111111111101011101
100000100000100010101
101011101110111110101
101000001000100010001
101111111010101010111
101000001010001010101
101011111011101110101
101010000010001000101
101010111110111011101
101010000010101010001
101011111010101011101
100000101010101010001
111110101010101010101
101000101010001010101
101011101011111010111
101000001000001010001
101111101111101011101
100000000000100000001
111111111111111111111
