111111111111111111111
101000000000000000001
101011111110111111101
101000100010100000001
101110101010111011111
100010001010001010001
111011111011101011101
100010000010101000101
101111111010101110101
100000001000100010001
111111101110111011101
100000100010101000101
101010111010101110101
101010001010001000101
101011101011111011101
101010101000000010101
111010101111111110101
100010001000001000001
101111111011101011111
100000000000100000001
111111111111111111111
