1111111111111111111111111111111111111111111111111
1000100010001000000000001000001000100000000000101
1110101010101011101111101010101010111110111010101
1010101000100000101000101010100010100010001010001
1010111111111111101010101110111110101011111011101
1010001000000010001010101000100010001010001000101
1011101011111010111110101011111011111010101010111
1010001000101010100000100010001000001000101010001
1010111110101010101110111110101111101111101111101
1010000000101010100010100000100000100000100000101
1011111111101010111011101110111110111110111110101
1000100000001010100010001000100010000000000010101
1011101011111010101110111011101011111111111010101
1010001000000010100000001010001000001000000010101
1010111111111110111111101011101110111011111110101
1010001000100000000010101000100010100010001000101
1011101011101111111010101110111110101110101011101
1000101000000010000010001000100010000000101000101
1010101111111010111110111011101011111111101110101
1010100010001010001010101000001000100000101010001
1011111010101111101010101111111110111110101011101
1010000010100000001010100000000010001000100010101
1010111110111111111010111011111111101011111010101
1010000010100000100010001000100000001010000000101
1011111010101010101011101010101111111010111111101
1000100010101010001010001010100010001000100000101
1011101110101011111010111010111010101110101110101
1000001000101010000010001010001000100010100010001
1011111011101011111011101111101111111011111011111
1000001010101010001000101000000000001000001000001
1111101010101010101110101011111111101110111111101
1000100010101000101000100010100010001000100010001
1011111110101111101111111110101010111011101010111
1010000010001000100000000000101000101000001010001
1010101110111010111111111110101111101111111011101
1000100010001010000000100000100000001000001010001
1111111011101011111110101110111111101011101010111
1000000000101010001000100010000010001010000010001
1010111111101010111010111011111010111011111111101
1010100000001000100010101000101010101000000010001
1010101111111111101110101110101010101111111010111
1010100000000000100010000010100010001000001000101
1011111111111110111011111010111011101110101111101
1000100000000010001000001010001000100010101000001
1010101111101111101111101011101111111010101011101
1010101000100000100010001000100000001010100010001
1010101110111011111010111110111111101011111110101
1010000000001000000000100000000000100000000000101
1111111111111111111111111111111111111111111111111
