1111111111111111111111111111111111111111111111111
1010000000001000000010001000100000001000000000101
1010101011111010111010101010111110101011111110101
1010101010000010101010100010100000100010001010001
1011101010111110101010111110101110111110101011101
1010001010001010100010000010100010100010101000001
1010111111101010101111111010111010101010101111111
1010001000101010100000000010001010101010100010001
1011101010101010101111111111101010101010111010101
1000100010000010101000000000100010101000101000101
1110111111111110111011111110111111101111101111101
1010000010001000100010100010001000101000000000101
1011111010101011101110101011101010101011111110101
1000001000101000101000101000100010001000000010101
1011101111101110101010101110111011111011111011101
1010000000100010001010101000001010000010001010001
1011111111111010111011101111101011111110101010101
1010000000100010001000100010001010001000100010101
1010111110101111101110111010111010101011111010101
1010100010101010000000001010001000100010001010101
1010101010101010111111111011101111111110101010101
1010101010001000001000000010001000000000100010101
1010101011111111101011111110111011111111111110101
1010101000000010001010000010100000100000100000101
1010101111101011111010101110111111101110101111101
1010101000001000001010100010100000001010101010001
1010111011111111101011101010101111111010101010111
1010100010000010001000101000101000000010101010101
1010101110111110111110101111101111111010101010101
1010101000100000100000101000100010001000101000101
1010101010101111101111101010101010101011101011101
1010001010101000001000001010001000101000001000101
1011111011101011111011111111111111101111111110101
1000001000100010100010000000000000101000100000101
1010101010111110101110111111111110101010111011101
1010101010000000101000100000001000101010001000001
1010111011111011101011101110111011101011101111101
1010100000001010001010001010100010100010101000101
1110101111111010111011101010101110101110101010101
1000101000100010100000101000101000100010100010101
1011101010101110101110101111101010111010111110101
1000001010001000101000100000001010100010001000101
1011111011111011111011101111111011101110111011101
1010000010000010000010100010000000000000100010001
1010111110111110101110111011111111111110101110111
1010000000100000101000001010001000001000100010001
1011111111111111101010111010101011101111111011101
1000000000000000001010000000100010000000000010001
1111111111111111111111111111111111111111111111111
