111111111111111111111
101000000000001000001
101111111011111011101
100010000010000000101
111010111110111111101
101010100000001000001
101010101111111011101
101010101010001000101
101010101010101110101
101010000010100000101
101011111010111111101
101000100010100010001
101110111110101011101
100010000010001000101
101011111011111010101
101000001000001010101
101110111111101110101
101010000000101000101
101011111011101011101
100000001000000010001
111111111111111111111
