111111111111111111111
101000000000100000001
101111111010101110101
101000100010101000101
101010101110111011101
101010100010000010001
101010111011111110111
100010000010100000101
111111111110101111101
100010001000001000001
101110101011111011101
100000100010001000101
101111111110101111101
100000100000100000101
111110101110111110101
100010101010000010001
101110101011111011101
100000100010000010101
101111111110111110101
100000000000100000001
111111111111111111111
