111111111111111111111
100000001000100000001
111111101011101011101
100000001000001000101
101111111011111110101
100010100010001000101
111010101111101011111
100010000000001000001
101111111110111111101
100000100010100000001
111110101110101111101
100010100000101000101
101010111111101011101
101010000000001010001
101111111111111010111
101000001000000010001
101010101010111111101
100010101010100000101
101110111010101110101
100010000010000010001
111111111111111111111
