1111111111111111111111111111111111111111111111111
1010000000100010000000001000000000000010000000001
1011101110101010101111101111111011101110101111101
1000001010101000101000101000001000100000100000101
1111111010111111101110101011101111111111111010101
1000000010001000001000100010001000000000001010101
1111101011101011111010111110111011111111101110101
1000001010100010000010001000100010000000100000101
1011111010111110111111101011111010101111111111101
1000001010000000100000101000000010100000001000101
1111101011111011101110101111111110111110101110101
1000001010001000100010001000001000100000100010101
1011111010101110111011111111101011101111111010101
1000001000100010001010000000001010100000100000101
1011101111111010101011111011101010111110111011101
1000101000001010101000000010101010100010001010001
1110101011111010101111111110101010101011101110111
1000101000001010100010001000101000101000100010001
1111101011101010111011101010101110101110111011101
1000001010100010001000100010101000101010001010001
1011111010111111101110111010101011101011101010111
1010001010000000001010001010001010101000100010101
1010101011111011111011101110111010101110111010101
1010100000001000100000100010101000100010000010101
1011111111101110111010111010101110111011111110101
1010000010101000000010100010100010101000001000101
1010111010101111111110101110111010101111101011101
1010101010000000000010100010100010001000101000001
1010101011111111111011111010101011101010101111101
1010001000001000000000000010001000100010100000101
1011101111101111111111111111111011111110101110101
1000100000100000000010000000001010000010101000101
1110111110111111111010111111101110101110101011101
1000000010100000001000100000100000100000101010001
1010111110101011101111101011111111111111101010111
1010100000101010001000001000000000000010001010101
1010101111111010111111101111111110101110111010101
1010101000001010000000101000100000101000100010101
1011101110101011111110101110101111111010111110101
1010001000100010100010100010100000100010100000101
1010111011111110101010111010111110101111101111101
1010001000100010001000100010000010100010001000001
1011101110101010111111111011101110111010111110111
1000100000101010001000001000001000101010000010001
1010111111101011101110101110111010101011111011101
1010000010001010001000100010100010001000000010001
1011111010111010111011111011101111101111111110101
1000001000001000000010000000001000000000000000101
1111111111111111111111111111111111111111111111111
