111111111111111111111
101000000000001000001
101111111110101110101
100000000000100010101
111111111111111010101
100000000000100010101
101110111111101110101
100010100010001000101
101010101010111011101
101010101000101010101
111011101111101010101
100010001000100000101
101010111010111011101
101010100010001010001
101010101111101010101
101010101000101010101
101110101010101010101
100000101010101010101
101111101011101110101
100000001000000000101
111111111111111111111
