1111111111111111111111111111111111111111111111111
1000000010000000100000001000000000001000000000001
1111111010101111101011101110111011111011111011101
1000000010100010001000100000100010000010000010101
1011111110111010111110111110111110111110111110101
1010100000101000100010100000100010000010100000001
1010101111101111111010111011101011111010101111111
1010000010000000000010001010001000000010100000001
1011111010101111111111101110111111111110111111101
1000100010101000000000101000100010100000100010001
1110101110111011111110101011101010101110101011101
1010100010100010000000001000001000101000101000101
1010111010101111111111111111111110101111101110111
1010100010100000100000001000000010100000001010001
1010111010111110101111101011101110111111111011101
1010001000100000100000100010101000000000100000101
1011101110101111111110111110101011111110101010101
1000101010100000000010100000100010000010101010101
1011101010111110111110111010111110111010111010101
1000001000100000100000100010100000101010000010101
1011111111101111101111101110101111101011111011101
1010001000100000101000001000101000001000101010001
1010101010111110101011111011101011111110101010101
1010100010000010001000001010001010001000100010101
1010111111111010111111101110111010101011111010101
1000100010000010100000001000101000100010001010101
1111101110111110111011101011101011111110101010111
1000000010001000000010001000101000100000101010001
1011111011101111111110111110101110101110101111101
1010001000100010000010100000100010100010100000001
1010111010111010111011101111101110111110111111101
1010100010100010100000001000000010100010101000001
1010101111101110111111111011111010101010101011111
1010100000001000000010001010001000101000100000001
1010111111111011111010101010101111101111111111111
1000100010000010000010101010101000000010000000001
1110101110111110111110101010101111111010111111101
1010100010000010001000101000100000001000000000101
1010101011111011101011101111111111101011111110101
1010101000000010001000100000000010101010000010101
1010111111111110111110111011111010101010111011101
1000100000000000100010100010100010101010100000101
1011101111111111101011101110101110101010111110101
1010000000000000101000001000000000101010000010101
1010111111111110101111111111111110101111111010101
1010000000100000100010000000100000101000001010001
1011111111101111101010111110111111101011101011101
1000000000001000001000000010000000000010000010001
1111111111111111111111111111111111111111111111111
