111111111111111111111
101000100000101000001
101010111010101011101
100010001010100000101
111111101010101111101
100000100010101000001
101111111110111011101
100000000010000010101
101111101111111110101
101000100010000000101
111010111010111011101
100010000010001000001
101111111011101111111
101000000010001000001
101011111110111011101
101000000010100010001
101111111110111010111
101000000000100010001
101011111111101111101
100000000000001000001
111111111111111111111
