111111111111111111111
101000100000100000001
101010101110111011101
100010100010100010001
111110111010101110111
100010000010001010101
101111111111111010101
100000000000000010001
101111111110111111101
100000100010000000101
111110101011111010101
100010001000100010101
111011111110101110101
100000100010100010101
101110101010111011101
100010001010101010001
101011111110101010111
101000000010001010001
101111111011101011101
100000001000001000001
111111111111111111111
