1111111111111111111111111111111111111111111111111
1000000010000000001000000000100000100000001000001
1111111010111110101011111110111010101011101111101
1000000010100000100010100010001010001010000010001
1011111111101111111110101011101011111011111010101
1010000000100010000000001000101000100010001000101
1011111010111010111111111010101011101110101111111
1000100010000010000010100010101010001000101000001
1110101111111111111010101111101010111011101011101
1010001000000010000010100000101010100010100010101
1011111011111010111110111110101010101110111110101
1000001010100010001000001000101010001010000000101
1011101010101111101111101010101111101010101011101
1010001010100000001000001010100000101000101010001
1011111010111111111010111010111110101111101010111
1010000010001000000010100010100000100000101010001
1010111110101110111110101110101111111110101011101
1010100000100010100000100010101000000000001010001
1010111010111010101111111010101111111111111010111
1010001010001000100010001010101000000010000010001
1011101011101111111010101011101011111011101111101
1000001000101000000010100010001000100000100000101
1011111111101011111110111110111010111110111111101
1000000000001010000010100000100010001010000010001
1111111111111010111010101111111111101011111010101
1000000000001010001000100000001000001000001000101
1011111111101011101111111111101011111011111111101
1000100000001010100000000010001010000000000010001
1010101111111010111111111010111011101111101110111
1010101000001010001010000010100000100000100000101
1010101111101010101010111010111110111110111111101
1010101000001000101010100010000000100010001000001
1110101011101111101010111111111111101111101011111
1000100010001000101010100000000000000000101000001
1011111110111011101010101111111111111011101011101
1010100010001000101010101000100010000010001000101
1010101011101110101010101110101010111110111111101
1010001000100000100010001000101000100000100000101
1010111011111110111011111011101110101111101110101
1010001000000000101000100010001000101000001000101
1011111110111111101110101010111111101011111011101
1010000010000000100010101010100000001010000010001
1010111011111110111010111010101111111011111010101
1010001010000000000010000010001000000000001010101
1011101011111111111011111011111011111011101010101
1000101000000000001010001000001010001000101000101
1010101111111111101110101111101110101111101111101
1010000000000000100000100000000000100000001000001
1111111111111111111111111111111111111111111111111
