111111111111111111111
101000001000001000001
101110101010101011101
101000101010100010101
101011101110111110101
101010100000100000101
101010111111111011101
100010000000000010001
111110111110111110111
100000100000100000101
101110111111101111101
101010000000100010001
101011111110111010111
101000001010001010001
101011101011101010101
101010101000101010101
101010101011101011101
100010001010001010001
111110111010111010101
100000000010000000101
111111111111111111111
