111111111111111111111
101000000000100010001
101011111010101010101
101000100010101000101
101011101110101111101
101010001000001000101
101010111111111010111
101010000000000010001
101111111111111111101
101000001000000000001
101011101011111111101
100010001000100000101
111110111110101110101
100010001000101000101
101011101011101011101
101000100010001000001
101111111110111111111
100000000010000000001
101110111111111111101
100010000000000000001
111111111111111111111
