111111111111111111111
100010001000000010001
111010111010111110101
100010000010000000101
101111101111101111101
101000101000100000101
101010111010111011101
101010000010001010001
101011111111101010111
101010001010001010001
101010101010111111101
101000101000000000101
101110101111111110101
100010100000001010001
111011111111101011101
101000000000101010001
101111111110101010111
100010000010001000101
101010101111111011101
101000100000000000001
111111111111111111111
