111111111111111111111
101000000000100000001
101011101110101111101
101010001000001000101
101010111111111010111
101010100000000010001
101110101111111110101
100010001000000010101
111011111011111011101
101000001000101000101
101111101110101110101
100000100000100010101
101111111111101010101
100000001000101000101
101111101010101111101
101000100010101010001
101010111110101010101
101010001000101000101
101011101011101111101
100010001000000000001
111111111111111111111
