111111111111111111111
100000001000000000001
111111101110111011101
101000100010101010101
101010111010101010101
101010001010001010001
101010111010111011111
100010000010100010001
101111111110101110101
100000100000100000101
111110111011111111101
100010001010000010001
101011101011101110101
101000101000101000101
101011101110101011111
101000101000001000001
101110101111111011101
101000100000001000101
101011111111101111101
101000000000000000001
111111111111111111111
