1111111111111111111111111111111111111111111111111
1000100000000000000010001000000000001000000010001
1110101111111111101010101110101111101011111010111
1010100010001000001010100010101000101010100010001
1010111010111011111010111011101010101010101111101
1000100000100010001000101010001010100010101000101
1011111111101111101111101010111011111110101010101
1000100000101000000010000010100010001000100010101
1110101110101011111110111110111010101010111110101
1010001010101000001000100000001000100010000000101
1011111010101110101011111111101111111111111011101
1000100010100010100010000000101000000000001010001
1010111010111010111111101110101011111111101010111
1010000010001010100000001000100010000000101010001
1011111111101010101111111011111011101010101011101
1000000000100010001000001000001000101010101000001
1011111110111111111010111111101110101010101111101
1010000010000000100010100000001000101010101000101
1011111011111010101011101111111011101011101010111
1000100000100010001010001000001000101000100010001
1110101110101011111110111110111110111010111111101
1010001010101010001000100010000010001010100000001
1011111010101010101011101011111011101110101111101
1000001010101010100010001000001000100000101000101
1010101010101110111110111111101010111011101010101
1010100010100000100010000000101010000010001010001
1110111110111111101010111110101111111010111111101
1000100010100000001010000010100000001010001000101
1011101010111111101010111110111111101011101010111
1010001010000000001010100000100000001010001010001
1010111011111111111011101111101111111110101011101
1000100000001000001010001000101000000000101010001
1011101111101011101010111010101010111111111010111
1000100010100010001000100010001010000010001010001
1011111010111011111111101111111111111010101011101
1010000010001010000000100010000000001000100010101
1010111110101010101111111010111111101110111110101
1010100000101010100000100010100000100010001000101
1010101111111010111110101110101110111011101010101
1010101000100010100010001000101000001000100010101
1110101010101110111011111010111011111110111110101
1000100010000010000010001010001010000010001010101
1011101111111111111011101011101010111011101010101
1010001000001000001000100000101000101000001000101
1011111011101011101110111111101011101111111111101
1000000010001010100010100010001010000000001000101
1011111110111010101110101010111011101111101010101
1000000010000000100000001000100000001000000010001
1111111111111111111111111111111111111111111111111
