111111111111111111111
100000100010000000001
111110111010111011101
100010001000001010001
111011101111101011111
100000100000101000001
101110111110111111101
100010100010000010001
111010111011111010111
100010000010000010001
101111111010111110101
100000001010100000101
101111101010111111101
100000101010000000101
111111101111111110101
100000001000001010001
101111111010101011101
100000000010100010001
101111111110111110111
100000000010000000001
111111111111111111111
