111111111111111111111
100010001000001000001
111011101011101011101
101000101010100010001
101110101010111110101
100010100000100000101
101010101111101111101
101000100010001010001
101111111110111010111
100010000010100000001
111011101010111111101
101000001010000000101
101111111010111110101
100000001010000010101
101011111011111110101
101010000010000000101
111010111110111111101
100010100010001000001
101110101011101011111
100000001000001000001
111111111111111111111
