111111111111111111111
101000000000100000001
101111101010101111101
100000101010001000101
111110111011111011101
100010100010000010001
101110101111101010111
101000101000101000101
101011101010101111101
101000100010100000001
101110111110111111101
100010000000100000101
101011111111101111101
101010000000001000001
101110111110101011111
100010100010101010001
111010101010101011101
100010101000101000101
101110101111111110101
100000100000000000001
111111111111111111111
