111111111111111111111
100010000000000000101
111011111011101110101
101000001010001010101
101111101110111010101
100000100010001010101
101110111010101010101
100010001010101010001
101011111011101011101
101000100010001000001
111110101110111011111
100010100000100010001
101010111111101110101
101010000010100010101
101011101010111011101
101000001010100010001
101111111010101110101
100010001000100000101
101010101111111111101
101000100000000000001
111111111111111111111
