111111111111111111111
100000100000100000001
111110111011101110101
100010001000001000101
101111101111101011101
100000101000101000101
111011101010111010111
100010001010001010001
101110111011101011101
100000100010101010001
101111101110101010101
101000001010001010101
101110111010111110101
100000100010100000101
111111101010111011101
100010001010000010101
101110111011111110101
100000100010000010001
101111101110111010111
100000100000001000001
111111111111111111111
