1111111111111111111111111111111111111111111111111
1010001000000010001000000000000000100010000000001
1010101011111011101011101111111111101010111111101
1000101000001010001000100010000000001000000000101
1111101011101010101110111010111111111111111011101
1000101010001010100010101000100010000010000010001
1010101110111010111110101111101010111010111110111
1010100000101010000000000000101010001010000010001
1011111111101011101111111111101010101011101111101
1010000010001000101000000000001010101010001000001
1010111010101110111011111111111011101011111011111
1010001000101000100010000000101000001000001000001
1010111111101011101110101110101111111111101110101
1010100000001000101010101000000000100000100010101
1010101111111110101010101111111110101011111010101
1000100000000010001000100000100010101000001010101
1011111111111011111011111110101010101110111011101
1010001000100010001010000010101010101010001000001
1010101010101011101010111010101110101011101111101
1000101010101000001000101010100000100010000010001
1111101010101111111111101010111110111110111110111
1000001010100000000000001010000010000000100010001
1011111010111111111110111011111011111111101011101
1000100010100000000010001010001000000000101000001
1110111110101111101011101010101111111110101111111
1000100010101000101000101000100010000010001000001
1011101010101010101111101111111011111011111011111
1010001010001010100000101000001000001010001000001
1010111011111010111110101011101111101010101011101
1000100010000010000010101010100010001000100010001
1111101110111111111010101010111010111011111110101
1000100000101000001010101010001000100000000010101
1010111111101011101010101010111111111111101110101
1010101000001000100010100010000010000000101000101
1010101011101110111110111110101010111110101011111
1010101010100010000010000000101010100010101010001
1010101010111011111011101111101010101010101010101
1010001000001000001000101010001010001010101000101
1011111111101011111110101010111011111010111110101
1010000000101000000010100010101000001010000010101
1010111010101111111010111010101111101011111010101
1010100010101000001010001010100000100010001010101
1010101110101011101011101110101111111110101011101
1010100010101010001000001000100010000000101010001
1010111011101010111111111011111010111111101010101
1000101010001010000000001000001010100010100010101
1011101010111011111111101111101010101010111110101
1000001000000010000000000000001000001000000000101
1111111111111111111111111111111111111111111111111
