111111111111111111111
100010100000001000001
111010101110101111101
100010001000101000101
101110111011101010101
100010100010101010001
111011101110101011101
101000001010001010101
101111111010111010101
100000100010000010101
101110101011111110101
100010101000100000001
101010101110101111111
101010100010100010001
101011111010111010101
101010001010000010101
101010101011111110111
101010100010001000001
101010111110101111101
101000000000100000001
111111111111111111111
