1111111111111111111111111111111111111111111111111
1010000000100000000000000000000010001000101000001
1011101110101111111111101111111010101010101011101
1000001010100000100000001000001000101010001000101
1111111010111110111110111011101111101011101011101
1000000010000010100010100010001000101010001010001
1011101011111010101011101110111011101011111010111
1010001010001010101000001000100000000010000010001
1010111011101010101111111011111111111110111111101
1010100000001010001000001000000000000000100010001
1010101111111011101011101111111111111111101110111
1010100010001000101010100000000010000000100010001
1110111110101110101010111111111010111110111011101
1000100010100000101010000000001000100010000010001
1010101010111111101010111111101111101110111110111
1010101000101000000010000000100000101000100010001
1011101111101011111111101110111110101011101011101
1000101000001000001000100010001000001010001000101
1010101011101011111010111011101111101010111110101
1010101000100010000010001000100010001010000010001
1010101011111110111111101011111011111011111011111
1010001010001000101000001010001000100010001010001
1011111110101011101011111110101110101110111010101
1000100000100010001000100000100000101000001000101
1110101111111110101110101111111110101011101111101
1010001010000000100010100000100000101010000010001
1011111010111110111110101110111111101110101110101
1000000010100000100000100010001000000000101000101
1011111110101011101111111110101011111111111011111
1000000000101010001000000010101010000000001000001
1011111111101110111111101011101010111111101011101
1000000000101000100000101000100010100010101010001
1111101111101011101010101110101110101010101110101
1000101000001010001010001010100010101010000010101
1011101011111011111011111010111010101011111010111
1000001010000010000010000010001010001000100010001
1011111010111110111111101011101111111110101111101
1010001010000010100000001000100010000000101000001
1011101011111010111110111011111010111111101011101
1000101000001000100010101010001010100000001000101
1110101111101111101010101010101010111110111110101
1010001000101000001000100010100010000010100000101
1011101110101010111111101110111111101010111011111
1010000000100010100000101000100000101010001010001
1010111111111110101110111011101110111011101010101
1000101000000000101010001000100010001010101000101
1011101011111111101011101110111011101010101111101
1000001000000000000000100000000010000010000000001
1111111111111111111111111111111111111111111111111
