1111111111111111111111111111111111111111111111111
1010000010001000001000000000001000000000100000101
1010101011101011101010111111101110101110101110101
1010101000101000101010000010100010100010001010001
1011101110101110101011111010111010111011111011101
1000001000101000100010000010001010001000001010001
1111111011101011111110111110101010111111101010111
1000000010001000100010101000100010100000001010101
1011111110101110101010101011111110101111111010101
1010001000100000001010100010000010101010000010101
1010111011111111111110101110111011101010111010101
1010001010001000001000101000101000001000101010001
1010101010101011101011101011101111111011101011101
1010101010101010000010001010100000001000101000001
1010101010101011111110111010101011101110101111111
1010101010101010001000100010001000101010100010001
1011101010111010101110101110111110101010111010101
1000100000100010100010101000100010100010001000101
1110111111101010111010101011101010111011101111101
1010001000001010101010001000101010100010001000101
1011101010111110101011111110101010101110111010101
1000101010100010001000000010101000101000100010001
1010101011101011101111111011101110111011101011101
1010101000001000000000001000100010100010101010001
1011101011111111111110111110111010101110101010111
1010001010000010000010100000100010100010001010001
1010111011101010111011101111101110111010111011101
1010101000001010101010001000101000100010001000101
1010101111111010101010111010101011101111101110101
1000100000100010101000100010001000101000101010101
1011111110101110101111111011111110101010101010111
1000000010000010100000000010001000100010100010001
1111111011111110111110111110111011111110111111101
1000001000100000100000100010000010000000100000101
1010111110101111101111101011101110111111101110101
1010100010101000000000001000101010100000001000101
1010101010101011111111111110101010111110111011101
1010101000101000001010000010100010000000100010001
1010101111101111101010111010111011111111101111101
1010100010000000100010101000100010001000101000001
1011111010111110101110101111101110101011101011101
1000001010100010101000100000100000100010001000101
1010111010111010111011101110111111111010111010111
1010100010000010100010000010000000001010100010001
1010101111111110101111111111101111111010111111101
1010100010001000100010001000100000000010000000001
1010111010101011101010101010111111111111111111101
1010000000100010001000100010000000000000000000001
1111111111111111111111111111111111111111111111111
