1111111111111111111111111111111111111111111111111
1010000000000000100000001000001000000010000000001
1010111111111011101011101010101111101011101111101
1010001000001000001010001010100010001000100000101
1011111011101110111010111110111010111110111110111
1000001000100010100010000010001010000010000010001
1111101110111010101111111011101010111011111011101
1000100000101010101000001000001010001010001000101
1011111111101010101110101111111011101010111110101
1000001000001010100010100000001010001010000000101
1110101011111011111011111110101010111011111011101
1000101000001000001000001000101010001000001000101
1011101110101111101011101011111011101111101110101
1000100010100000101010001010000010100010001000001
1110111011111010101110111010111110111010111111101
1000100010000010100000100010001000001010100000101
1011101110111110111111111011101111101010101110111
1010001000001000001000001000100000100010100010001
1010111111101111111010101011111110111110111011101
1010000000001000001010100010000010100010001010101
1011111111111011101010111110111010101011101010101
1000100000001000101010001000100010101000100000101
1110101111101110101011101011101110101110111111101
1000100000100010101010101010100000101010000000001
1011101111111010101010101010111111101011111111101
1000001000000010100010100010000000001000001000101
1011111010111110111110111110111011111011101011101
1010100010100000100000001000101000100010100010001
1010101011101111101111101011101110101010111010111
1000101010001000000010101000100010101010100010101
1011101010111110111010101110101010101010101110101
1010001010000010001010001000001010101010001000101
1010111011111011111010111111111110101011111011101
1010100000001000001010000010001000101000000010001
1010111111111111101011111010101011101111111110101
1010100000000000101000001000101010100000100000101
1010101111111110101011101111101010111110101111111
1010001010000010101010001000101010000000101000001
1011111010101010101010111010101010111111101011101
1000101000101010001010000010100010100000001010101
1110101011101011111111111110111110111011111010101
1010100000101010000000000000100010001000000000101
1010111111101010111111111111101011101011111111101
1000100010001010101000100000001010001010000000001
1011101010111010101010101110111010111010111111101
1010001010100010100010101010100010100010100000101
1010111010101110101110101010111110111110101110101
1000100000100000100010000010000000000000100010001
1111111111111111111111111111111111111111111111111
