111111111111111111111
101000001000000010001
101011101110111010101
100010100000100010101
111110111111101110101
100000001000100010101
101110101110111010111
100010100000100010001
111010111110101110101
100010101000100010101
101110101011111011101
101000100000001000001
101011111111111111101
101010000000001000001
101010111111101011111
101000100000101010001
101111101011101010111
100010001000101010001
111011111110101011101
100000000000100000001
111111111111111111111
