111111111111111111111
100000001000000010001
111111101110111010101
100000100000101000101
101110111111101111101
100010000010001000101
101011111010101010101
101010001000100010101
101010111111111110101
101010000000000010101
101011111011111010101
101000001000001010101
101111101111101010101
101010001000001000101
101010111111111111101
101010000000100000001
101011111110101111111
101000000010101000001
101110111010101110101
100000100010000000101
111111111111111111111
