1111111111111111111111111111111111111111111111111
1000100000001000000000101000100000000000000000101
1110101011101010111110101010101111111111101110101
1010101010001010001010100010000000001000001000001
1010111010111111101010111111111111101011111111101
1010000010100000001000000000001000101010000010001
1011111110101011111011111111101010101010111010111
1000000010101000100010001010001010001010100010001
1111101010101110111110101010111011111010101111111
1000001010101010000000101010101010001000100000001
1011111010101011111011101010101011101111111111101
1010000010100010001010001010100000001010000000001
1011101110111110101110111010111111101010111111101
1000100010001000100000100010100000100010001010001
1010111011101011111111101010101110111011101010111
1010100000100010100000001010101010100010001000001
1010111111111110101011111110101010101110111111111
1010001000000000001010000010001010101010000000001
1111101011111111111010111011111010101011111111101
1000001010000000100010101000100000100010000010001
1011101011101110101010101110101111111010111010101
1010001000001010101010001000100000101000100010101
1011111111111010101111101010111110101011111010101
1000000000100000101000001010101000100010001010101
1011101111101111101011111010101011101110101110101
1000101000000000101010001010001000101010100000101
1110101011111111101011101011101110101010101111101
1000100010000000101000101010000010100010101000101
1011111110111110101110101011111110111010111010101
1000000010100000101000101010000000101010000010101
1111111010101111101011101010111111101011111110111
1000100010100000001000101000101000000000000010001
1110101110111111111110101111101011111111111111101
1000101010000000000000100000000010001000001000001
1011101011111111111111101111111110111011101011101
1010001010000000000000100000000000100010100010001
1010111010101111111110111111111111101110111110111
1010101000100000101000100000000000100010000010101
1010101011111110101011101111111110111011101110101
1000100010000000101010000000001000001000100000101
1011111110111111101010111111101111101110101111101
1000000000100010000010000000100010000000100000001
1111111111111010111111111110111011111111111111101
1010000010000010100000000000001000101000000010001
1010101110101010111111111011111010101011111010111
1000100000101010000010001010001010100010100010101
1011111111101111111010101110101110101110101110101
1000000000100000000000100000100000100000100000001
1111111111111111111111111111111111111111111111111
