1111111111111111111111111111111111111111111111111
1010000000001000001000001010000000000010001000001
1010111111101010101110101010111110111010111011101
1000100000101010101000100010001010100010000010101
1111101110101010101011111111101010101110111110101
1000001010001010101000000000000010101010001000101
1011111011111110101110111111111010101011101110101
1010000010100000100010001000001010101010000000101
1010111010101011111011111011101110101010111111101
1010101010001000101000001010100000101000100000001
1010101011111110101111101010111111101111101111101
1010101010000000101000100010100000100000001000101
1010101010111111101010111110101011111111111010101
1010101000100000100010000000101000000000100010001
1010101111111010101111111011101111101111101111111
1000100000000010101000001000101000101000100010001
1111101011111110101011111110101011101010111010101
1000001000100010101000000010100010001010000010101
1011111110101010101011101110111010101011111111101
1000000010001010101010001000001010101000100000001
1111111011111011101010111011111010111110101111111
1000001010001000101010100010000010100000100000001
1010111010101110101110101010111110101111101111101
1010000010100010101000101010100010101010000000101
1011111111101110101011101110101110101010111111101
1000100000100010001000100010001000101000101000001
1110111010101011111010111011101011101110101011111
1010100010101000000010001000101000100010001000001
1010101110101111111110101011101110111011111011101
1010101000100000000010101000101010001000001000101
1010101011111011111110111110101010111111101111101
1010101000100010000010000010101010100000101000001
1010101110101110111010111010101010101011101011101
1010001010100010001010001010001010101000001010001
1011111010111011101011111011111010101111111010111
1010000010100000101000100010000010100010000010001
1010111010111111101110101010101010111011101111101
1010101000100000001010001010101010001000101000101
1010101111101111111011111010101110111110101010101
1010001000001000100000001010100010100000101010101
1011101011111010101011111011101010101111101010101
1000101010001010001010001000101010001000000010101
1011101010111011111010101110111011111111111110101
1000001010100010001000100010000010001000100000101
1011111010101110111111101111111010101010101111101
1010000010101000001000001000001010100010001000001
1010111110101111101011111011101010111111111011111
1000100000000000001000000000100000100000000000001
1111111111111111111111111111111111111111111111111
