1111111111111111111111111111111111111111111111111
1000000000000000001000000000100000000010000000001
1111111111111111101011111110101111111010111011101
1000101000000000100010000010001000001010001010001
1010101011111010111110111011111011101011101011101
1010001010000010000010001000101000101010101000101
1011101010111111111011101110101010111010101110101
1010001010001000000000001010100010001010001000101
1011111011101111111111111010111111101011101011101
1000001000100000000000100010000010001000101010001
1111101110111111111110101011111010111110101011101
1000101000100000000010101000001000100000101000101
1010101011111111111010111110101110101111101110111
1010101000000000000010100010101000101000100010001
1010101111111011111110101010101011101010111011101
1010001000001010000000101010100010001010001010001
1011111010111010111110101011111110111110111010101
1000000010000010100010101000100000100010100010101
1011111111111110101011101110101111101010101110111
1010000010001000101000001000101000001010101010001
1010111011101010101111111010101011111010101011101
1010101000001010101000001010101000100000101000101
1010101110111010101111101011101010111111101010101
1000100010100010101000001000001010000000000010101
1111101110101110101011101111111111111111111111101
1010000000101000101010101000001000000000001000001
1010111111101111101010101011101011111111101011101
1000100000100000101010000010000010000000100010101
1011101110111110101011111111111110101110111110101
1000001000100010001010000010001000101000100000001
1111111011111011111010111010101011101011101111111
1000001010001000001000101000101000101000100000001
1011111010101110101011101111101110101111111111101
1000001000101000101000001000101000100000100000001
1011101111101011101111101110101011111110101111111
1000100000100010100000100000101010000010001000101
1111111011111110111110111110101110111010111010101
1000001000000000000010001000100000001010100010001
1011101111111011111011101110111111111010111011101
1000100000001000100010100010000010000010000010001
1110111111101111101010111011111110111111111110111
1000100000000000001000100010000000100010001000101
1011111111111111101111101110111111101010101011101
1010000000100000001000101000001010001000101010001
1010111110111111111010101011101010101111101011101
1010100010001000000010001000101010101000101000101
1010111011101011111111111111101010101010111110101
1000000000100000000000000000001000100010000000001
1111111111111111111111111111111111111111111111111
