111111111111111111111
100010000010000000001
111011111010111110101
101000001000100010101
101111101011111010111
100010001010000010001
101110111011101111101
100010001010001000101
111011101010101010101
100010101000101010101
101010101111111010101
101000101000000010001
101110101011111111101
100010101000000010001
101011101111111010111
101000101000000010101
101110101011111110101
101010100010100010101
101010111110101010101
100010000000001000001
111111111111111111111
