111111111111111111111
100000100000001000001
111110101011111010101
100010101000000010101
111010101111111110101
100010100010000000101
101010111010111111111
101010101010000000001
101110101011111111101
101000100000001000001
101011101111111011101
100010001000100010001
101111111010101110111
101000000010101000101
101110111110101011101
101000101000101000101
101011101011101110101
101000101010001010101
101110101011101010101
100000100000001000001
111111111111111111111
