111111111111111111111
100000100000000000001
111110101111101111101
100010101000100010101
111010111010111010101
100010100010101000101
101010101110101011101
101010001010100010001
101111111010111110101
101000000000100010101
101011111111101010101
101000100010001000101
101110101011101111101
100010101010001000001
101010101010111011111
101010001010001010001
101111111010101011101
100000001010101000101
101011111011101110101
101000000000001000001
111111111111111111111
