111111111111111111111
100010000000000010001
111011111110111010101
101000001000100010101
101111101011101111101
100000101010101000001
111110101010101010101
100000100010001010101
101111111110111110101
100000000000100000101
101111111111101111101
101000000000001000101
101111101111111110101
101000001000000000101
101011111010111110101
101000101010100000101
101110101010111111101
101000100010000010001
101011101111111010111
100010000000001000001
111111111111111111111
