111111111111111111111
101000100000100000001
101010101011101110111
101010101000101010001
101110101110101011101
100010000010100010001
111011111110111010101
101010000010000010101
101010111010111110111
101000100010100010001
101111101110101011101
100000100010101000101
101010111010111010101
101010100010100010101
101011101110101011101
101000001000001010001
101111111011111110111
100000100010000010001
111110111110111011101
100000000000100000001
111111111111111111111
