111111111111111111111
100000000010000000001
111111111010111111101
101000000010100010001
101011111110111010111
101000100010001010001
101110111011101011101
100010001000001010001
101011101111101010111
101000100000100010001
111011111110101111101
100010000010101000101
101010111010101010101
101010001000101010101
101111101111101010101
100000100000101010001
101011111110101011101
101000000010101000101
101111111010111110101
100000001000000000101
111111111111111111111
