1111111111111111111111111111111111111111111111111
1000000000000000100000000000000000000000000000101
1111111111111110111111111011111111111110111110101
1000000010000010000010001010100010000000100010101
1011111010101111111010101010101010111111101110101
1000001000100000001000101010001010000010100010001
1111101111111111101111101011111011111010101011101
1000100010100000100010001000001000001010001010001
1010111010101011111010111111101110101010111010111
1010001010001010000010000000100010101010101000001
1011101011111010111011111110111010101010101111111
1010100010001010101000001000100010101010000010001
1010111110101010101111101011101110101010111110101
1000000000100010100000001000100010101010100000101
1111111111111010111111111110111011101010101111101
1000000010001010000010001000100010001010100000101
1111111010101011111010101011101110111011111011101
1000000010101000001000101000100010001000001010001
1011111110101111101111101110111010101111101010111
1000001000100000100010100000100010100010001010001
1111101011111010111010111111111011111010111011101
1000001000001010100010000000001000000010100010101
1011111011111010101111111110101111111010101110101
1010001010000010101000000000100000100010100000101
1010101010111110101011111111111110111110111011101
1000101010100000100010000010001010001000100010001
1011101010111110111110111010101011101011101110101
1010100010000010001000101000101000101000000010101
1010111111111011101011101111101010101111111010111
1010100000001000101010000000101010100000100010001
1010101111101110101011101011101010111110111111101
1000101000100000101010001010001010000010000000101
1110101011111111101010111010111011101111111110101
1000101000000010001010001010100010001000000010101
1011101011111010111011101110111010111011101010101
1010001010001000100000101000000010101010101010101
1010111011101111111110101011111110101010101110101
1010001000000000001000101010000010101000100000101
1011101111111111101011101010111010101110111111101
1010001000000010001010000010101010001010100000001
1110111011111010111010111110101011101010101111111
1000101000101010100010000010001010001010100000001
1011101110101010101111111011101010111010111111101
1000100000001000001000000010001010100010001000001
1010111111111111111011111010111010101011101011101
1010100000100000001010001010101010001010001000101
1010101110101111101110101110101011111110111110101
1010000010000000100000100000001000000000000000101
1111111111111111111111111111111111111111111111111
