111111111111111111111
100010000000000000001
111011101111101111111
101000101000100010001
101110101010111010101
100010101010001000101
101110111011101111101
101000100010001000001
101011101110111011101
101010000010001010101
101011111011101010101
100010000010001010001
101110111110111010111
101000100010100010001
101011101110111011101
100010000010001000101
111110111011101010111
100010101010001010001
101010101010111111101
101000001000000000001
111111111111111111111
