111111111111111111111
101000000010000010001
101110101011101011101
100010101000001010001
111011101111111010101
101000101000001000101
101110101011101111101
100000100000100010001
101111111011111011111
100000001010001000001
111111101010101011101
100000101010101010101
101010101010101010101
101010101010101000101
101011101010101111101
101000001010100000001
101111111110111111101
101000000000100000001
101011111111101111111
100010000000000000001
111111111111111111111
