1111111111111111111111111111111111111111111111111
1000000010100000100000000010000010000000000000001
1111111010101010101111111010111011111111101111111
1010000010101010001000001000101000001000100000001
1010111110101011111011111111101111101010111111101
1000100000001010000000000010000000100010001000001
1011101111111011111011111010101110111111101011101
1010001000100010001010000010100010100000100010001
1010111011101110101010111110111010101110111110111
1010000010001000101010100000100010001000001010001
1010111110111011101010101111101111101111101011101
1010100010000000101010101010001000001000100000101
1011101011101111101110101010111111111010111110101
1000001000101000100010000010100010000010100000101
1111111110111010111010111110101010111110111111101
1000001000100010001010101000101000100010000000101
1011101011101111101010101011101111101111111110101
1010101010000000100010001000100000100000000010001
1010101011111110111111101110111110111011111011111
1000101010000000101000100010000010001010001010001
1110101010111111101010111011111011101011101010101
1000100010000000100010001000001000000010001000101
1011111111111110101111101110111111111110111111101
1010000000000010100000100000100000100010000000101
1011111110111010111110111111101110101110111011101
1000000000101010100010100000000010100000001010001
1111111111101010101011101111111110101111101010111
1000001000001010001000000010000000101000101000101
1011111011101011111011111010111111111010111110101
1000001000101000001010001010001000001010100010101
1011101011101111101110101111101011101010101010101
1010100010000010001000100000100000100010001010001
1010111110111010111011111110111111111110111011101
1010001000100010000010000010001000000010001010001
1010101011101111111110111011101011111011101011111
1010101000100000100000101000001010001010101000001
1010101110111110101111101111111010111010101111101
1010100010100000101000000000100010000010001000101
1010101110111111101111101011101010111110111110101
1010100010000000100000101000001010100000000000101
1011111011111110111110111111111010101111111111101
1000000000001000000010100000000010100010000000001
1111111111101011111110101111111110111010111111101
1000100000101000000010001000001000100010000000101
1011101011101111111011111011101011111111111110101
1010001000001010000010001000101000001000000000101
1010111111111010111110101110101111101011111111101
1000000000000010000000100000100000000010000000001
1111111111111111111111111111111111111111111111111
