111111111111111111111
101000000000001000001
101111101111101111101
100010001000100000001
111010101010111111101
100010101010000010101
101110111011111010101
101000000010000010001
101111111110111110111
100010000000100010101
111010111111101110101
101000100010000010101
101111101110111010101
100000101000100010101
111010101011101010101
100010001000101010001
101111111110101111101
101000000000100000101
101011111111111011101
100000000000001000001
111111111111111111111
