1111111111111111111111111111111111111111111111111
1000001000000000101000000010000010000000100000001
1111101011101110101011101010101010111011101110111
1000101010001010101010101010101000100010000010001
1011101110111010101010101110101111101110111111101
1000101000100010100000100000101000100010100010001
1010101011101110101111111011101010111110101010101
1010001000100010100010001000101010000010101000101
1011111110101010111110101110101011111010101111101
1000000000101010000000101010100010001000101000101
1111111111101011111111101010111111101111101010101
1010000000101010000010001010100000001000101010101
1010111010111010101110111010111011101010101011101
1010001010100010100000100000000010000010101000101
1010111010101010111111111111111111111111101110101
1000100010001010100000000010000000000000100010001
1011101111101110101111111010111111111110101010111
1000101000001000100010100010001000100010101010101
1110101111111011101010101111101011101010111010101
1000100010000010001010000000001000001000100010001
1011111010111110111011111111111011111111101111101
1010001010100010100010001000001000001000001000101
1010101010101110101110101011101111101011111011101
1010101010101000100000100010101000101010000010001
1010101010101011111111111110101110101010111010111
1000101010101000000000000000100010001010001010001
1111111010101111101111111110111010111011111011101
1000000010100000101000000010001010001010000010001
1011111010101011101011111011101011101010111010111
1010100010101010001000001010001010100010001010101
1010101110101110111111101011111010111111101110101
1010101010100010001000001010001010000000100010001
1010101010111011101011111010101010111110111011101
1010000010100010001010001000100010000010000010001
1011111110101110111011101111111110111011111110111
1000001000100010101000101000000010001000000000101
1011101011111010101110101011101111101111111111101
1000100010000010001000100010100010001000000000001
1110111110101110111011101110111010111011111111101
1010100000100000100010101000001000100010001000001
1010101111111111101110101111101111101110101011111
1010100010000000001000100000001000001010100010001
1010111010111111111010111111101111101010111110101
1010100010001000000010001000100000001010100010101
1010101111101010111111101010111111111010101011101
1000101000101010000010001010000000100010101000001
1011111010101011111011111011101111101010101111101
1000000010001000001000000000100000001000001000001
1111111111111111111111111111111111111111111111111
