111111111111111111111
100010000010000000001
111010111010111011101
101010100010001010101
101010101111101010101
100010101000001010001
101110101111111010111
100000101000000010001
111111101011111111101
100010001000100000101
101110111010111011101
100010100010001000001
111010101111101111111
100010101000100000001
101010111010101111101
101010000010100010001
101111111110101110101
101000100000101000101
101010101111111011101
100010000000000010001
111111111111111111111
