111111111111111111111
101000000010000000101
101110111010111110101
100000101000100000101
111111101111101111101
100000000010100010001
101111111010111010101
101000001000100010101
101011111110101110101
101000000000101000101
101111101111101011101
100000100010001010001
111110111110111011111
100010100000100010001
101010101111111010101
101000100000001010101
101111111111101010101
100000000010001000101
101111101110111111101
100000100000000000001
111111111111111111111
