1111111111111111111111111111111111111111111111111
1000000010000010000000100000000000000000100000001
1111111011101011101110111011101111111111101111101
1000100010001000001010100010001000000000001000101
1010101110111111111010101011111011111111111010101
1010101000100000100010101010000010100000101010001
1011101011101110111010101110111110101010101011111
1010001010001000100010100010100000101010001000001
1010111010111011101010101010101011101011101111101
1000100010101010001010101010101000001000101000101
1011101110101010101110101010101111111010111010101
1010001000100000101000101000101000001010000010101
1011101011111111101011111110111011101111111110101
1000101010001000101010000010000010101000000000101
1110101010101010111010111011111110101010111110101
1000101000100010001010100010000000001010100010101
1011101011111111101010101110111111111011101011101
1000101010001000001000101000000000000010001000101
1110101010101010111111101011111111111010111110101
1010101000101010100000001010001000100010001010101
1010101111101011101111111010101010101111101010101
1000100010001000001010000010101010100000101000001
1011111010111111111010111110101110111110101111101
1000000010100000100000100000100010000010100000101
1111111110101110111111101111111011111010111110101
1000000010100010000000001000001010000010100010101
1010111110101011111111111011101010101110101010111
1010100000101010001000100010101010101000101010001
1010101111111010101011101110101010101011111011101
1010001000000010101010001000100010101010000010001
1011111011101110101010111011111110111010111010101
1010001000101000101000100000100000100010100010101
1011101010111011101011111010101110101110111110101
1000100010001010001000001010001010001000000010101
1110101111101010111111101011111011111111111010101
1010101000100010000010101000100000001000001010101
1010111010111111101010101110101011101011101010101
1010100010000000101010100010101000101000100010101
1010101111111110111010111010111110101110111110101
1010100010000000100010100010000000100000100000101
1010111010111111101110101111111110111111101111101
1000100010000010001010001000100000100000100010001
1011101111111011101010111010101111101110101011111
1000101000001010001010100010001000101000101000001
1110101011111010111010101111111010101011111111101
1010101000001000100010100010000010001010001000001
1010101011101111101110111110111111111010101011101
1000001000100000000000000000100000000000100010001
1111111111111111111111111111111111111111111111111
