111111111111111111111
100010000000000010001
111010111111111011101
100010000000100010001
101110111110101110111
101010001010100010001
101011101010111011101
101000001010001000101
101110111011101110101
100010000010101010001
111011111010101011101
100010001010101000001
101110101010101111111
101000101000100000001
101011101011111111101
101010101010000000001
101010101010111111101
101010101010100010001
101010101110101110111
100010000000100000001
111111111111111111111
