1111111111111111111111111111111111111111111111111
1010001000100010001000000000000010000000100000101
1010101010101010101011111011111011111010111010101
1010101010101010100000101010000000000010000010001
1010101010101011111110101011111111111110111111101
1000101010001010001000101000001010000000100000101
1111101011111010101011101111101010111111101110111
1000100010001000101010000010001000100000100010001
1110111111101111101010111010111111101110101111101
1000001000001000101010100010000000100010001000001
1011111010101110101011101011111110111011111011101
1000100010100000101000001010000010000000001010001
1010101110111110101111111011111011111111111010111
1010000010100010101000101000000000100010000010001
1011111110101011101010101011111111101010111111101
1010000000101000100010100010000000001000100000101
1110111110101110111110101110111110111111101011101
1000100010101010000010100010100010100000101000001
1011101010101011111010111110101011101110111111111
1010101000101000100010000010001010001010000000001
1010101111101010101111111011111010111011111110101
1010001000101010101000001000001010001000100010101
1010111110101110101011101111101011101011101011101
1010000000101000100010000010001000000010001000001
1011111011101011111110111010111111111110111111101
1010100010001000000010001010001000100010000010001
1010101110111111111011101011101010101010111010111
1010001000100000000010001000100010001010001010001
1011101011101010111110111111111111111011101011101
1000101010001010100000100000000010001000101010101
1010101011101010101111101110111110101110101010101
1010101000101010101000001010000000100000101010101
1010111110111010101011111011111111111111101010101
1010100000100010100010000000001000000000101010001
1010101111101110111111111111101011101110111010111
1010101000100010000000001000001010100010100010001
1010101011101011111111101011101010111010101111101
1010101000001000000010001010001010001010001000101
1010101111111111111010111011111010101011111010101
1010100000000000000010100000000000101000100010001
1110111111111111111110101111111110111110101111111
1000001000100000000000100010000010100000101000101
1011111010101111111111111010111011101111101010101
1000000010001000100000001010101000001000101010001
1011111111111010101111101110101111111011101011101
1000001000001010001000100000100000000010001010001
1111101110101011111010111111101110111110111010111
1000000000100010000010000000000010000000000010001
1111111111111111111111111111111111111111111111111
