111111111111111111111
100010000000001000001
111011111110101111101
101000000000101000001
101111111111101011101
101000000000100010101
101011111110111110101
101000100010000010001
101110101010111110111
101000101010100010101
101011101010101010101
101000101010101000101
101110101010101111101
100000101000100010001
101111101110111010101
101000101000100010101
101010101111101110101
100010100010001000101
111110111010111110101
100000001000000000101
111111111111111111111
