111111111111111111111
100010001000001000001
111010111010111011101
101010000010000010001
101010111111111110101
100010001000000000101
101111101011111111101
100010001000001000001
111011111111101111101
101000000010001000101
101111111010111010111
101000000010000010001
101011111110111111101
100010000000001000101
101110111111111010101
101000100000000010001
101111101111111111101
100000101010001000001
111110101010101011111
100000001000100000001
111111111111111111111
