1111111111111111111111111111111111111111111111111
1010001000000010000010000000000000001000000000001
1010111010111011101011101111111111101011111111101
1010100010001000001000001010000000001000000010001
1010101111101111111111111010111111111111111010111
1010001000101000000000100010100000100010000010001
1011111010101010111111101010111010101011101111101
1000000010001010000010001010001010001000101000101
1111111111111011111010111011101011111110111010101
1000000000001010001000101000101000100010000010001
1110111111101011101111101110101110101111111111101
1000100000001000100000100010100000100000100000001
1011111111111110101110101010111111101011101111111
1000000010000010001000101010000000001000101000001
1011111010111011111011101111111111111110101011111
1010001010101000001000100000000010000010101000001
1010101010101110111110101011111110111010101011101
1010100010001010100000101000100010100000101000101
1010111111101010101111101110101010111110101110101
1010100000101010101000100010001010000010101000101
1110101110101010101110101111111011111011101011101
1000100010000010100010001000000000101000001000101
1011111011111110111010111011111110101111111110101
1000000000100010100010001010000010000010000010101
1111101111101010101111111010111011111010111011101
1000100010001000101000000010001000100010101000101
1010111110111110101011111110101111101110101110101
1010000000100010100010100010101000001000100010101
1011111111101011111110101010101011111011101110101
1000000000001000000000101010101010100010000000101
1011111111111111111110101010101010101011111110101
1000000000100000000010001010100010001010000010001
1111111110111011111011111010111110111010111011101
1000001010000010100010001000100010001000101010101
1011101011111110101111101111101011101111101010101
1000100000100000100010000010001000100000001010001
1110111110111011111010111010101110111110111010111
1000100000000010000010100010100010100010100010001
1011101111111110111110111011111010101010101111101
1000100000100000100000001000100010001010100000101
1010111110101111111011101110101111111010111110101
1010001000100010001010001000101000001010000010101
1011101011111010101110111011101011101011111010111
1010101010000010101000101000101000101010000010001
1010101110111110101011101110101110111010111110101
1010100010001000100010000010100010001010100010101
1010111011101011111110111110111010101011101011101
1000001000000010000000000000000010100000001000001
1111111111111111111111111111111111111111111111111
