1111111111111111111111111111111111111111111111111
1010000010000010000000000000001000000000100000101
1011111010111010111111111011101111111010111010101
1000001010101000101000001010100010000010000010101
1111101010101111101011101010111010111111111110101
1000101000000000001010000010001000100000001000101
1010101011111111111011111110101111111010111011101
1010001010000000000010000010100000000010100010001
1011111010111011111110111011111111101111101111101
1010000010100010000010101010000000001000100010001
1011111110111110111010101010111111111010111010111
1010000010000010001010001010000000000010001010001
1010111010111011101011101011111110111110101011101
1000100010100000101000001010000010100010101000101
1111101110101111101111111010111011101010111110101
1000101000100010000010001000100010001010000010001
1010101110111010111110101011101010111010111011101
1010100010001010100010101000101010101010100010001
1011111011111010101010101110101110101010101010111
1010001000001000101000100010100010101010101010101
1010101111101011101111111010111010101011101110101
1000101000001010001000001010001010101000100000101
1011101011111010111011101011111010101110101111101
1010100010000010001010001000001000000010101000101
1010111110111110101010111111101111101110101010101
1010000010100010101010000000100010001000100010001
1010111010101011101110111110111011111011111111111
1010001000101000100010000010001000001000000000001
1011111111101110101011101111101111101011111111101
1000100000101000101010001000001000101000001000101
1110101110101011111010111011101011101011111010101
1010001010001010000010101010001010001010000010001
1011111011111011101110101010111010111110111111101
1000001010001000100010001010000010000010100000001
1011101010101110101011111010111111111010101111111
1000100010100010101000100010100000001000100000101
1010111110111010111110101110101110101111111110101
1010000000100010100000100010101000101000100010001
1111111111101110101111101011101011101010101011101
1000000010001000101000101000001010001010101000001
1011111010111011101010101111111011111010101111111
1010001010001000101010100010000010000010101000001
1010101011101110101011101110111110111110101110101
1000101000000010101000001000100010001010100010101
1011101111111010101011111010101011101010111010101
1010001000000010001010001010101010001010100010101
1010111111111111111010101011101010111010101111101
1010000000000000000000101000001000000010000000001
1111111111111111111111111111111111111111111111111
