111111111111111111111
101000001000000000101
101010101111101110101
101010100010001010001
101110111010111011101
100000101010100000101
111111101010101110101
100000001000100010101
101111101111111010101
101000100000001010001
101110111111101011111
100010000010001010001
111011111010111010101
100010001000100010101
101110101111101111101
100010100000001000001
111010111111111011101
100010001000000000101
101111101111111110101
100000000000000000101
111111111111111111111
