111111111111111111111
100010000010000000001
111010111010111110111
101000101010100010001
101111101010111011101
101000001010000000101
101011101010111110101
101010100010100010101
101010111111101010101
101000000000101010101
101111111110101011101
100000000010101000101
101110111110101110101
101010000010001010001
101011111011111011101
100000101000100000001
111110101110101111111
100010101000100000001
101110101011111111101
100000001000000000001
111111111111111111111
