1111111111111111111111111111111111111111111111111
1010000000000000000000101000001000000000001000001
1011111111111011111010101010111010111111101011101
1000000010001010000010100010001010000010001010001
1111111010101110111110101111101011111010111010111
1000000010100000100000101000001000100010000010001
1011111110111111101111111011111110101111111111111
1000100010001000100000100010001000100000000000001
1110101110101011111110101110101011111111111110101
1000100000101000001000100000101010001000000010101
1011111111101110101011101111101010101011111010101
1010000010001000101010101000100000101010000010101
1010111010111011111010101011111011111010111111101
1010001000100010000010000010001010000010000000101
1011101111101010111111111110101110111111111110101
1010001000001010001000001000100010100000100010001
1010111110111011101110101011111010101011101011101
1000100000100010100000100010001000101000101000001
1111101011101110111111111110101111101110101111111
1000101010000000001010000000100000101000100000101
1011101011111111101010101111111111101011111110101
1000001000101000001000101000001000001000000010101
1011111110101011111111101011101011111111111010101
1010001000101010000000001000101010001000001000101
1010101011101010101011111110101010111010111111101
1000101010100010101010000010100010001010000000001
1011111010101111101110111010111111101011111011101
1010000010001000001000100010100000100010000010101
1110101111101011101011101110101110111110111110101
1000101000101010101000100000101000100010001000001
1011111010101010101110111111101110101010101111101
1010001010100010000010100000100010001010100000101
1010101010111111111010101110111011111010111110111
1010101010001000100010001010000010100010100010001
1010101011101010111111111011111110101110101011101
1000101000100010000000000000100000001000001000101
1011101110111111111111111010101111111111111110101
1000100010100000000000100010101000001000000010101
1110111010111111111010101111101010101011111010101
1000100010000000001010101000001010100010000010101
1011101011111111101110101011111110111110111110101
1010001010000000100000101010000000100010001010101
1110111110111011111110101010101111101011101010101
1000100010001000000010101010100000101000001000101
1011101011101110111110101010111110111110111011101
1000101000101010100000100010000010000010001000101
1010101011101010101111111111111111111011101111101
1010001000000010000000000000000000000010000000001
1111111111111111111111111111111111111111111111111
