111111111111111111111
100010000010000000101
111010111010111010101
100010001000100010101
101111101111101110101
100010000000100010001
111011111110111011101
101000100010001000101
101110101011101110101
100010101000100010101
101010101110101110101
101010001010101000101
111011111010101011101
100010000010101000101
101110101110101110101
100000101000101000101
101111101011111011101
101000101010000010001
101110101010111110111
100000100000100000001
111111111111111111111
