1111111111111111111111111111111111111111111111111
1010100000100000000000000000000010000000000000001
1010101110101111111110111111111010111011111111101
1010000010001000100000100000100010001010001000001
1011111111101010101111101111101111101010101111111
1000100000101010001010000010001000101000100000001
1110101110111011111010111010111011101111111111101
1000100010001010001010101010101000001000101000001
1011111011101010101010101010101011111010101011101
1010001010100010100010001010100010000010001010101
1010101010111110111111101010101111101111101010101
1010101010000000000010001000101000100010001010001
1010101010111111111010111111101010111011111011101
1000100010000010000010001010000010000010001000101
1111111111111110111011101010111111111110101010111
1000100000000010001010101010100000100000101010001
1010101011111011101010101010101110101111101011101
1010101010001000101010101000101000101000101000101
1011101010111110101010101110101110101010101110101
1000001010000000001010100010100010001010101000101
1011111011111111111010111010111011111011101011101
1000001000001000001000001010100010000000101010001
1111101111101011101111111011101111111110101110101
1000100000100010100000001000001000000010100000101
1010111110111110111111101111111011111010111111101
1010000010000010000000100000001000001000001000001
1011111011111011111110111011101110101111101011111
1010100010001010000010001010100010100010001010001
1010101110101010111010111010111010111010111010101
1000100000101000101000100010001010001010001010101
1110111111101111101110101110101010111010111010111
1010001000101000001000100010101010100010100010001
1011101010101010111011111010101011101110101111101
1010001010100010001000001010100000001010100000001
1010111010111111101111101011111111111010111111101
1010001010000010100010001000000000001000001010001
1011101111101010111010111111111111101111101010111
1000100000001000001000100000000010100000100010001
1010111111111111101111101011111010111110111111101
1010000000001000001000001010001000001010000000001
1011111111101011111111111010101111101011111111111
1000000000101010000000100010100010001000000000101
1011111110101010111110101110111110111011111110101
1010001010101000100010101000000010001000000010001
1010101010101111101010101110111011101111111011101
1010101010101000101000100010100010001000001000101
1010101010111010101111111010101110111011101110101
1000100010000010000000000010100000000010000000101
1111111111111111111111111111111111111111111111111
