1111111111111111111111111111111111111111111111111
1000000000100000000010000000001000100010000000001
1111111110111111101010111111101010101110111011111
1010000010000000101010100000001010100000101000001
1010101011111110101010101111111010111011101111101
1010101000000010101010100000001010001000101000001
1010101111111110101010111111101011101110101011101
1010100010000000101010001000100010101000001000101
1010111010111111101011101110111110101111111110111
1010101000100000101000101000000010101000000010001
1010101111111010101110101011111010101011111011101
1010100000100010001010001010000010100010001010001
1010101110101111111011111011111010111111101010101
1000100010001000000010000010001000100000001000101
1011111011111111101110101110101110101011111111101
1000100010000000001000100000100010001010000000101
1110101110111111111011111111111011111010101111101
1010001000000000001010001000001010000010100000101
1011111011111111101010101011101011111110111110101
1010000010100000001000100010001010001000100010001
1010111110101011111111111011111010101011101011111
1010000010101010000000100010001000101010001000001
1011111010101110111011101110101111101010101111101
1000000000101000001000001000100000001010101000101
1011111111101011111111111011111110111010111010111
1010001000100000100000000010001000100010000010001
1110101010111111101110111110101111101111111011101
1000100010100000001010100000100000001000001010001
1011111110101111111010101111111111111011101110101
1010000000001000100000100010000000000010100000101
1011111111111011101111111010111110111110111111101
1000100000100010000000001010001000100010000000001
1110101110101010111111111010101111101011101111111
1000100010101010100000000010100000101000101000101
1011111010101110101111111111111110101110101010101
1000001010100010101000000000100010001000101010001
1110111010111010101011111010101011111011101011111
1000100010001000101010000010101000000010001000001
1011101111101011101110111110101111111110111110101
1000101000101010001000100000001000000010000010101
1010101110101110111011111110111111111011111010101
1010100010101000100000000010100010000010001010101
1110111010101011111011111011101010111011101010101
1000001000100010001010001000001010001000001010101
1011111110111110101110101111111010101110111010101
1010000000100000101000100000000010100010100010101
1010111111111011101011111111111110111011101111101
1000000000000010000010000000000000001000000000001
1111111111111111111111111111111111111111111111111
