1111111111111111111111111111111111111111111111111
1000100000100000100000000000001000000000000010001
1110101010111010111111111011101111101011111010111
1000101010000010000000000010100000101010001010001
1011111011111111111111111110111110111010111011101
1000001010000000100000000000000010000010001000101
1111101010111110111011111111111111111111101110101
1000100010001000000010000000000000000000100010001
1011111110101111111010111111111111111010101111101
1000000010100000101010001000001000000010100000101
1111101110111110101011101110101011111110101110101
1000001000001000100010001000101010100000100010101
1011101011111011101110111011101010101111111110101
1000101010100010000010100000101010100000000000101
1010101010101111111110111110111010111111101111101
1010101010100000000010100000100010000010001000001
1010101010111111111010101111101111111010111011111
1010101010100010000010100000101000100010101000101
1010101010101010111110101110101010101010101110101
1010101010001010100010100010101010101010000010101
1110101011111010101010111110101010101111111010101
1000101000000010001010000000100010101000001010101
1011111111111011111011111110111110101010111010101
1010000000001010001000100000100010100010000010101
1010111011111011101011101111111010111110111110101
1000101000100010001000001000000010000010000010001
1011101110101110111111111110111111111010111111101
1000100010001000100000000000100000100010100000001
1110101011111010101111111011101110101111101111111
1010001010001010001000001000001000101000001000001
1011111010111011111010111111101011101011111011111
1000100010000010000010100000101010001010000000001
1011101111101111111010101110111010111011111011101
1000001000100000000010101000000010001010001010001
1011111010111111111110101111111011101010101110101
1010000010100010000000100010001010100010100000101
1011101110101011101111111011101010111110111111101
1010001000101000100000001000101000100000100010001
1010111110101110111111101110101110111011101010111
1010000010101010001000001000100010001000101010101
1011111010101011101111101011101111101110101010101
1010000010001000100000101000100000101000101010001
1010111111111010111110101110101010101011101011111
1010101000000010000010101000101010101000001000001
1010101011111011101110111011111010101111111011101
1010100010000010001000100010000010100000001000101
1010101110111111111011101110111111111111101111101
1000100010000000000000001000000000000000000000001
1111111111111111111111111111111111111111111111111
