111111111111111111111
101000001000000000001
101110101010111111111
101000101010100000001
101011111010101111101
101000000010000000101
101110111110111111101
100010100010100000101
111011101011101110101
101000001000001000101
101111111111111011101
100000000010000010001
101111111010111110101
101000100010100000101
101010111110101110101
100010001000100010101
101111101011111110101
100010001010000010101
111010111011101010101
100010000000001000101
111111111111111111111
