111111111111111111111
101000000010000000001
101011101110111111101
101000101000100000001
101110111011101111101
100010001000101000101
111011101110101011101
101000100000101000101
101110111111101010101
100010001000101010001
101111101010101011111
101000100010001010001
101010111111111011101
101010100000001010001
101010101011101010111
100010001010001010001
101111111010111010101
100010001010100010101
111011101011101111101
100000001000000000001
111111111111111111111
