111111111111111111111
100000100000000010001
111110111011111010101
100010001000100010101
101011101110101110101
101000001000100000101
101111111011111011101
101000001010001000101
101011101010101110101
100010001010101000101
111110111110101110101
101000100000100010101
101011111011111010101
101000000010100010101
101111111110101111101
100000001000101000001
101110111010101010101
100010100010001010101
111010101111111110101
100010000000000000101
111111111111111111111
