111111111111111111111
101000000000001000001
101111101011111011101
100000101000000000101
111110101111111111101
101000101000001000001
101011101011101011111
100010001000101000001
101110111010101111101
101000001010101000001
101111101110111011101
101000101000100010101
101010101010101110101
100010100010101000001
111110111011101011111
100010001010001010001
101011101110111010101
101000100000101010101
101110111111101010101
100010000000000000101
111111111111111111111
