111111111111111111111
101000000010000000001
101111111010101111101
100010000010101010001
111010111110101010111
100010000010101000101
101110111010101110101
101010001000100010001
101010111111111011101
101000100000001010001
101111101111101010111
100000001010001010101
111111111010111010101
100000100010100010001
101110101010101111111
101000101010100000001
101011101010101111101
101000001000101000101
101111111111111010101
100000000000000010001
111111111111111111111
