111111111111111111111
101010000000100000101
101010101110111010101
101000101000001010001
101111101111101011101
100000100010100010101
111110111010111110101
100010000010000000101
101011111110101111101
101000100000101000001
101110101111101011111
101000101000001000001
101011101010111111101
101000001010100000101
111111111011101110101
100000000010001010001
101110111110111011111
101000100000100000001
101111101111111111101
100000000000000000001
111111111111111111111
