1111111111111111111111111111111111111111111111111
1000001000001000001000100000000010000010000000001
1111101011101110101010101011111011101010111011101
1010001010100010100010001000001010001010100010101
1010111010111010111111111111101010111010101110101
1000100010000010100010000000101000100010100010101
1011101110111110101010111110101111101111111010101
1010000010101000101010100010001000100000001010001
1010111010101011101010101011111010111111101011101
1010001010100010001010101000001010000000101000101
1011111010111011111010101111101011111010101110111
1000000010001000100010101000001010000010100010001
1111111111101110101110111011111010111111111010101
1000000010001000100010100010000010000010000010101
1011101110111011101010101110111111111010111111101
1010001000100000101010100000000000100010000000101
1110101011111110101010111111101111101111111110101
1000101010000010101010100000101000001000000010101
1011111010111010101010101110111011111011111010101
1000000010101010101010000010001010001010001000101
1011111110101010111011111111101010101010101111101
1010001000100010000000001000001000101000101010001
1010101011101111111111111011111011101111101010101
1010100010001000100000100010000010000000101000101
1010111110111010101110101011111010111110101111101
1000100010100010001000001010001010100000100000001
1111101110111011111111111010101010111111111111101
1000100010001000000010000010101010000000000000101
1010101011101011111011111110101111111011111010101
1010101000101000001000001000100000001010001010101
1010101011101111101111101011111111101010101010101
1010001000001000101000001000100000001010101010101
1011111111111110101011111110101111111010101011101
1000000010000000101010000000101000001010101000001
1111111011101111101010111111101111101011101111111
1000001000101000001000000010001000001010000010001
1011101110101011111111111010111011101010111110101
1010000010100000100010001010100000101010001000101
1011111110111011101010101010101110111011101011101
1000000010001010001000101010101010001000100010001
1011111011101110111111101010101011101110101110101
1000101000100010000010101010100010000010101000101
1110101110111011111010101010111010111110101011101
1010100010001010000010001010100010001000101000101
1010111011101010111111101110101111101011101110101
1000100010100010000000100000101000001010001000101
1011101010111111111110111111101011111011111011101
1000001000000000000000100000001000000000000010001
1111111111111111111111111111111111111111111111111
