111111111111111111111
101000100000000010001
101110101110111010101
100010001010100010101
111010111010101111101
100010100010100000101
101110111010111110101
101000001010001000001
101111101011101111101
100010000000100000101
111010111111111010111
100010100000001010001
101111101111101011101
100000001000001010001
111111111011111110101
100000000010001000101
101111111110101011101
100010000000100010101
111011111011111110101
100000000010000000001
111111111111111111111
