111111111111111111111
100010000000000000001
111011111011111110101
101000001000100000101
101111101111101111101
100000100000100000101
101110111110111110111
101010001000100010001
101011101011101010101
101000100010001010101
101010111110111011101
100010100000101010001
111110101111101010101
101000100000101010101
101011111110101010101
101010000000101000101
101010111111101111101
101000101000100000101
101111101010101110101
100000000010000010001
111111111111111111111
