111111111111111111111
101000000000001000001
101111101111101011101
100000101000001000101
111110101011111110111
100010001010000010001
101111111010101010101
101000100010101010101
101010101111101011101
101010100000001000001
101010111111111111101
100010000010000000101
101111101010101011101
101010001010101010001
101010111010101110111
101010001010100010101
101011101010111010101
101000101010101000101
101110101110101111101
100000100000000000001
111111111111111111111
