111111111111111111111
101000000010000010001
101110111010101110101
100010001000100000101
111011101111111111101
100010101000001000001
101110101111101011101
101000000000001000101
101111111111101110111
100010000010000010001
111010111011111111101
100010100010000000101
101110101110111110101
100010100010000010001
111010111011111011101
100010001000100010101
101111101110101110101
100000001010001000101
111111111011111010101
100000000000000010001
111111111111111111111
