1111111111111111111111111111111111111111111111111
1000000010000010000000000000100000100000000010001
1111111011101010101111111110101011101011111010101
1000100010001010100010001000101010001000001000101
1011101110111011111010101011101010111111101111101
1000101000101000000010100010001000100000100010101
1110101011101111111110111110111111101011111010101
1000100010000000000010000010000010001000100010001
1011111111111111101011111011111010111110101111101
1000000000000000001000001000101010100010100000101
1011111110111111111111101110101010101110111110111
1000100010100000000000100010100010001000000010001
1110101010101111101111101110101111101010111110101
1010001010100010001000001000100010001010100010101
1011111010111110111011111011111011111011101011101
1000001010000010001000001010001010000010001000101
1011101011111010101011111010101010111010111110101
1000101010001010100010000010101010001010000010101
1110101010101011111110111110111011101011111010101
1000100010101000000010100000000010001000100010001
1011111110101111111010111111111010111011101111101
1010000010100000001010000000001010100010001000101
1011101110101111101011111111101010111110111011101
1000100000101000001000000010101000100000100010001
1110111111101111111111101010101111101111101010111
1000100000100000000000101010101000001010001000101
1011101110101111111110101010101011111010111111101
1010001010101010001000101000100010000010000000001
1010111010101010101010101110111110111011111111101
1000100010100010101010101000100000100000001000101
1111101010111110101010101110101111111110111010101
1000001010001000100010100010100000001000100010001
1110111011101011111110111010111111101011101111111
1000100010001010001000001010100000001000101000001
1011101110111010101111111010101111111111101111101
1000101010100010100010001010101000000010001000001
1110101010101110111010101010101011111010111011101
1000100010101000100000100010001000001000100010101
1011111110101011111111111111101111101111101010101
1000000000101000000010000000000010001010001010101
1011111111101111111010111111111110111010111010101
1010000010100000100010100000001000100000001010101
1010101010101110101111101111101011111111101010101
1010101010001000100000001000001010000010101010001
1011101011111010111111111011101010101010101011101
1010001000100010001000001000101010101010001000101
1010111110101111101111101110111011101011111110101
1000100000001000000000000010000000001000000000101
1111111111111111111111111111111111111111111111111
