111111111111111111111
101000000010000000101
101010111010111010101
101010101010001010001
101110101011111011101
101000100010000010001
101011101110111110111
100010100010001010001
111110111010101011101
101000001010101000001
101011101010101111101
100000101010100000101
111111101011101110111
100010001000100010001
101010111110111111101
101000100000100000101
101111101111101110101
101000001000101010001
101011111010101011101
100000000010001000001
111111111111111111111
