1111111111111111111111111111111111111111111111111
1000100010000010000000001000100000100010000000101
1110101010111010111111101010101110101011111010101
1010001000100010000000100010001010001000001010001
1011111111101110111110111111111011111111101011101
1010000000001010100010100000000000000000101000101
1010111111111010101110111110111011111110101010101
1010000010000010001000100000100010000010101010101
1011111011111011101011101011111110111011101010101
1000001000001010001010001010000010001010001010101
1110101111101010111011101010111011101010111010111
1000100000101000001010001010101000101000100010001
1011111110101111111010111010101010101111101111101
1010000000100000000010100010001010100010001000101
1011101111111111111110101111101011111010111011101
1000101010001000001000101000001000000010100000101
1110101010101011101010111011111111111110111110101
1000100010100000100010001000001000000010000000101
1011111010111111111111101111101011101110111110101
1010000010001010000000001000101010001000100010101
1011111111101010111111111010101011111011101010101
1000100000001010000000000010101000000010001010101
1010101111111011111111111110101011111110111010101
1010001000000000000000000010001000000010100010101
1011111010111111111111111011111111101110101111101
1010001010000000001000001010000010001000100000001
1010101111101111101011101010111010111011111111101
1000100000100000101000100010001000001010000010001
1111111110111110101110111111111111111010111010111
1000001010001000100010000010000000000010100010001
1010101011101111111011111010111111111110111111101
1010100000100000100010001000100000000010000010001
1110111011111110101110111111101111111110111010111
1000100010000010101000001000001000000000001010001
1011111110111010101111101011101011111111111011101
1000100010100010101000101010001010000010000000101
1010101010101010101010101010111011101110111110101
1010001000101010101010001010001000001000101000101
1011111111101010101011111011101111101011101011101
1000100000001010001000100010001000101000100000101
1111101111111111111010101110101010101110111111101
1000101000001000001010001010100010101010001000001
1010101011101010111011111010111110101011101011111
1010001010101010000010000010100000100010100010001
1011111010101011111110111010111011111010111110111
1010001010101010000010100010001000001010000010001
1010101010101011101011101011101111111011101011101
1000100000100000001000001000100000000000001000001
1111111111111111111111111111111111111111111111111
