111111111111111111111
100010000000000010001
111010111110111010101
100010001010001010101
101111101011101011101
100000100010101000001
111110111010101111101
100000101010100000101
101111101010111110111
101000000010001010001
101011111010101011101
101010001000100010001
101110101111111010101
100000101000000010101
111111101111111110101
100000101000100010101
111011101010101010101
100010001010101000101
101110111010101111101
100000000010001000001
111111111111111111111
