1111111111111111111111111111111111111111111111111
1000100000000000000010100000100000000010000000001
1110101111111111111010101110101111111010111011111
1000100010000010001010101010100000001000001000001
1011111010101110101010101010111111101111111110101
1000000010100000101010000010000000100010100010101
1111111110111111101011111111111110111010101011101
1000001000100010001000000000000010000000101000101
1111101011111010101111111111111011111111101110101
1000101010001010100010000000001010000000100010001
1010101010101010101110111110111010111110101011101
1010100000100010101000100010001000100010101010001
1010111111111110111011101011101111101010111010111
1010000000100010000010001010000000001010000010101
1011111110101010111110111110111011111111111110101
1010000010001010000000100000100010001000001000101
1010101111111011111111101111101110101011101011101
1010100000001000000010001000100010100010101010001
1010111111101111111010111110111010111110101010101
1010001010000000101000100000100010100000101000101
1011101010111110101111101010101110101110101111101
1010000010000010000010001010100010101000100010001
1011111111101011101110111011111010101111111010111
1010000000101000101000001000000010101000000010001
1010111110101110111011111111111110101011111111101
1010101000100010000010100000000000101010001000001
1010101011111011111110101111111111101010101011111
1010101010001010001000101000001000001000101000101
1010101010101010101010101110111011101111101110101
1010001010101000100010100010001000100000100010001
1010111010101111111110111010101110111110101111101
1000100010101000100000101010100000100000100000001
1011101010101110101111101011111110101110111111111
1000101010101000100010001000000010100010100000001
1110101010101011111010111111111011111010101111111
1000101010101000100010000000001000000010100000001
1011101110101110101111111110101111111110111111101
1010001000101000101000000000100000001000100000001
1110101011101011101011111111111111111011101111101
1000101010101000001010000000000000001010001000101
1011101010101111101010111111111111101010111010101
1010101000100000100010001000001000100010000010101
1010101110111110111111101110101010111110111110101
1010101000100010100000100000101010100000100000101
1010101011101010101110111111101010111111101111101
1010001010101000100010000000101010100000101000101
1011111010101111111011111110101010101110101010101
1000000000100000000000000010000010001000001010001
1111111111111111111111111111111111111111111111111
