1111111111111111111111111111111111111111111111111
1010000000100000000000001000000000001000000000001
1011101110101111111111101011111011101011111110101
1000101010101000100000100010001000101010100010101
1110101010111010101110111010101110111010101011101
1000101010100010100010001000100010000000101010001
1011101010101110111011101111111011111111101010101
1000001010001010001010101000000000000010001000101
1111111011111011101010101011111111111110111111101
1000000010000010001010101000000010000010100010001
1011111110111010111010101111111010111010101110111
1000000000001010001010001000001010100010100010101
1011111111111011101010111011101010101110101010101
1010001000000000100010100010101010100010101000001
1010101011111111111110101110101110111010111111111
1010101000001000000010001000100010001010100010001
1010101111101011101111111010111011101010101010101
1000100010101000100000001010001010001000101000101
1011111010101011111111101011101010111110101111101
1010001000100010001000001010001010000010101000001
1110101111111110101011111010111010111011101011111
1000100000000000100010000010100010001010001000001
1011101111111111111010111110101110111010111111101
1000101000100000000010100010100010100010000000101
1110101010111011111110111010111011101110111111101
1000101010001010000000100010000010001000100000001
1011101011101110111111101011111110111011101111101
1010001000100000100000001010000010000000100010001
1010111110111111101110111011101110111110111011111
1010100010000010000010101010001000100010101000001
1011101011111011111110101010111011101010101111101
1000101010000010000000100010000000101010000010101
1010101010111110111111101110111111101011111010101
1010101000101000100010001000101000001000100000101
1110101111101010101010111110101011111110111110101
1000101000001010101010000010001000100010000010101
1011101011101010101011111011111110111011111011101
1010001010101010101000001010000010001000001000001
1010111010101010111011111010111010101110101111101
1000100000100010001000001000100010101000101000101
1011111111111111101111101111101111101011111010101
1000000000000000100000100000101000101000000010001
1111111111111110111110101110101010101110111111111
1000000000000010000010101000100010100010100000001
1010111111111111111010111010111110111010111110101
1010000010000000000010001010000010100010000010101
1011111010111111111111101011111110101111111011101
1000001000000000000000001000000000001000000000001
1111111111111111111111111111111111111111111111111
