1111111111111111111111111111111111111111111111111
1000100000000000100000001000000010000000100000001
1110101111111110101011101011101110101011101110101
1010100000001010001000101010101000101010000010101
1010111111101011111110101010101011101110111110101
1010100000100010000010101010001000101000100000101
1010111110111011101010101010111110101011101111111
1010000010000010001010100010000010101010100000001
1011111010111110111010111110111110101010111111101
1000001010001000101010100010100000101000100000101
1110101011101011101010101011101111101110101111101
1000101010100010001010101000000000100000001000001
1011111010111110111010101111101111111111111011101
1000001010100000001010001000101000100000000010001
1011101010101111101011111010111010101111111110111
1010001010000010100000001010000010101000100010001
1010111011111010111111101011111110101010101011111
1010000010001000100010001000001010100010001000001
1011111110101011101011111111101010111110111111101
1010000000101010001000000000101000100010100000101
1010111110101010111111111110101011101011101110101
1010100000101010100010000010001010001000101010101
1010101111101110101010111011111010101110101010101
1010101000100010101000001000001010101010101000001
1011101010111010101111111010111011101010101111101
1000001010100010101000001010001000001000100010001
1111111010101110111011101111101111111011101010111
1000000010100010001010100000100000100010101010001
1011111110111011101010111110101110101110101011101
1000100010001000101010001000100010100010001010101
1110101011101110101011101011111010111010111010101
1000101000100010100000001000001010001010001010101
1011101110101110111111101111101011101011111010101
1000100010100010001010001000101010001000000010001
1110111110111011101010111010101010111111111110111
1010001000100000101000001010001010000000100010001
1011101011101011101111111011111110111010101011101
1010001010001010001000001000000010101010001000101
1010111010111110111011101011111010101011111110101
1010001010000010000010101000001010001010000010101
1011101011111011111110101111111011101010111010101
1000100000001000001000100000000010101000001010101
1011111111101111101010111111111110101111111011101
1000000010001000100010000010000000101010000010001
1011111010111011111110101110111010101010111110111
1000001000100000000010101000100010101010100010101
1111101111111110111010111011101111101010101010101
1000000000000000100010000000100000000010001000001
1111111111111111111111111111111111111111111111111
