1111111111111111111111111111111111111111111111111
1010000000100000001000001000100000000000001000001
1011101110101111101110101010101111111011101011101
1000100010001000101000100010100010000010001000101
1110111011111011101011111110111110111110111110101
1000100010001000100010000010100000100000100000101
1011101110101010111110111010101111101111101111101
1000001010101010000000100010001000101000000010001
1111111010101011111010101111111010101111111010111
1000000000100010001010100010000010100010000010001
1111101111101110101110111011111011111010101111101
1000101000100010101000101000100010000010101000101
1010111010111110101011101110101110111110111010111
1010000010000000100010000010100010100010000010001
1011111111111111111110111110111010101011111011101
1000000000001000000010000000100010101000001000101
1111111011101110111110111111101010101111101111101
1000001000100010001000100000001010100010001000001
1011101111111010101011101011111110101010111011101
1010000000001010101000101010000010101010000010001
1011111111101010101110111010111010111011111111111
1010001000100010100000000010101010001000000000001
1010101110101111111111111110101011101011111110101
1010100010001000100000000000101000001010000010101
1010111011101010101111111111101111111110111011101
1000001000101010001000000010000000000010100000001
1111111110111011111010111110111011111010111111101
1000000010001010000010001000100010100010000010001
1011111011101011111111101011101110101111111011101
1010001000101000100000100010101000100000001000101
1011101110101110101110101110101011111111101110101
1000100010100010001010100000101000100000101000101
1010101010111011111010111111101110101110101011111
1010101000000000001000100000100010101010101000001
1010111111111111101011101110101010101010101111101
1010100000000000101000001010101010101010001000101
1110101111111110101111111010101010101011111010101
1000101000001000101000000010101010101000000010001
1011101111101011101011111110111010101110111011101
1000100000101010100010000010001010000010100010001
1010111110101010111010111011101011111011101110111
1010001000101010000010001000001000001000001010101
1011101011101011111111101111111111101111111010101
1010101010001010000000101000100000101000001000101
1010101010111010111110101010101110101011101011101
1010100010100010100010100010001000101000100010001
1010111110101110101010111111111011101110111111101
1000000000100000001010000000000000001000000000001
1111111111111111111111111111111111111111111111111
