1111111111111111111111111111111111111111111111111
1000100000000010100000001000001000001000000000001
1110101111111010101111101011101011101011111110101
1010101000001000100010001000100010001000100000101
1010101011101111111010111110111110111110101111101
1000100010100000000010000000000010001000101000001
1011101110111111111111101111111011101011101111111
1000101000100000000000101000001010100000100000001
1110101110101111111110111011101010111111111111101
1000100000100010000010100010001000100000000000101
1011111011111010111110101110111111101111111110101
1000100010000010000000101000000000001000000010101
1110101110111110111111101111111111111010111010101
1000100010001000000000100010000000001010001010101
1011111011101111111110101010111111101011101110101
1010000000100000100010101000000000101010100000101
1011111111111110111010111111111110101010111111101
1000001000000010001000000000000010101000100010001
1111101011111011101011111111111010101110101110101
1000100010100010001010001000101010101010100000101
1011111110101110111110101010101010101010101111101
1010000010101000000000101010101010101000101000101
1010101010101011111111101010101011101011111010101
1010101000101000100000100010100010001000000010001
1010101111101110101111111010101110111111111111101
1000100000001010001000001010100000100010001000001
1011111111111011101011101110101111101010111011111
1010000000100000001000101000101000101010001000001
1010111010111011111110101011111010101011101111101
1010100010001010000000100010000010101000100010001
1011101111101010111111111010111110101110101010111
1000001000101010100010000010100010101000101000101
1111111011101110101011111010111010101011101111101
1000100000100010101010001010000010001010100000001
1110101110111010101010101111111011111010111111101
1000101010100010001010101000000000100010000000101
1011101010101110111010101011111111101110111011101
1000100010001000001000100000001000001010001000001
1010111011111111101111111111111011111011101111111
1010001010000010100010000000001000100000100000101
1010111010111010111010111111101010101110111110101
1010100010001010000010100000001010100010001000101
1010101110101011111110101111111010111011111011101
1010101000101000000000101000001010001010001010001
1110101011101111111111101011101011101010101010101
1000101010001000001000101010101000101010101010101
1011101110111011111010101010101111101010101010101
1000000000100000000010000010000000001000100000101
1111111111111111111111111111111111111111111111111
