111111111111111111111
101000100000100000001
101010101110101110101
100010001000101000101
111111111011111011101
100000100010000010101
101010101110111110101
101010100000100000101
111010111111111011101
100010100000000010001
101110111011111010111
101000000010001010001
101111101110101011101
100000101000101000101
101110111011101110101
101010000010001000101
101011111110101111101
100010000010101000101
111011101010111010101
100000001010000010001
111111111111111111111
