1111111111111111111111111111111111111111111111111
1010000000100000000000001000000010000010001000001
1011111010111011111111101011111010111010101011101
1000001010000010000010101000101010100010100010001
1111101011111110111010101110101010101110111110101
1000101000001010001010100000100010100000000010101
1110101011101010101010111111101110111111111010111
1000101010001010101000101000101000101000100010001
1011101010111010101110101010101011101010111111101
1000001010100010100010001010001000001010000000101
1011111110101010111011101011111011111011111110101
1010000000101000001000101010000010001000100000001
1011101111101111111110111010111110101010111111111
1010001000100010100010100010100000101010000010001
1010111010111010101010101110101111101110111010101
1000100010001010101000100010101000100010001000101
1111101110101010101110111010101010111011111111101
1000101010101010100010101010101010100010001000001
1011101010101010111010101011101110101110101011111
1000001010101000101010001010001000100000101010001
1111101010101110101011111010111011111111101010101
1000100010100010101010001000101000000010101000101
1010111110111110101010101111101011101010101110101
1010000000100000101010101000000000101010100010101
1011111110101111101010101011111111101010111011101
1010000010101000001000100010001000001000101000001
1010111010101111101111111110101011111110101111101
1010100010100010000010000000101000100010000010001
1010101111111010111011111011111110101011101110111
1010101000001000101000000010000000101000001000101
1010101010111111101111101110101111111111111011101
1000101010100000000010001000101000000000001010001
1011101010101111101010111011111011111111101010101
1000100010000010001010101010001010000010101000101
1011111111111110111010101010101010101010101111101
1010000000100010001010001000101010101000100000001
1010111110101011101111101111101010101111111111111
1010001000101010001000101000100010101000100000001
1011101011101010111010101110111110101010101011101
1010001000001000100010001000001000100010001010101
1010101111111111101111111011101110111111111010101
1010101000000000101000000010100010001010000010001
1110101011111110101011111110111011101010111011111
1000101010000010101000001000001010101010001010001
1011111011101010101011101010111010101011101110101
1000001000001010001000101010100010000000100000101
1011101111111011111111101011101111111111111111101
1000100000000000000000001000000000000000000000001
1111111111111111111111111111111111111111111111111
