111111111111111111111
100010000000100000001
111011111110101110101
100010000010001010101
101110111010111010111
101000101010100010001
101011101010101011101
100010100010001010001
111110101111111010101
100010001000101010101
101110111010101010111
100010000010101010001
101011111110101011101
101000001010100010001
101110101010101110101
101010100010100010101
101010111010111110101
101010001010100000101
101011101110101111101
100000100000001000001
111111111111111111111
