111111111111111111111
101000001000000000001
101110101110101111101
100010100010100000101
111010111011111110111
100010100010000010001
101110111010111011101
101000001000100010001
101110101111101110111
100010101000001000001
111010101011111111101
100010101000000000001
101110101111111111111
101000100010000000001
101111111010111111101
100010000010000000101
111010111110111111101
101010000000100010001
101011111111101010101
100000000000001000101
111111111111111111111
