111111111111111111111
100010000010000000101
111010111010101110101
100010100010100010001
101110101111111011101
101000100000001010101
101011111111101010101
101010000000101010001
101011111110101011101
100010000010101000101
111110111010101110101
100010001010100000101
101011101010111111101
101000101000100010001
101110101110111010111
100010001010100010001
101011111010101111101
101000001000001000101
101111101111111010101
100000100000000010001
111111111111111111111
