111111111111111111111
100000001000001000001
111111101011111011101
100010001010000010001
101110111010111110111
101000100010100010001
101011101110111011101
100010000000001000101
101111111111101010101
101000001000100010101
101011101010111111101
100010100010000000001
111110111111111111101
100000001000000000101
111110101010111111101
100000101010001000001
101111111011101011111
101000000010100010001
101011111110111111101
100000000000000000001
111111111111111111111
