111111111111111111111
101000000000100000001
101011111110101011111
101010000000101010001
101010111111101010101
101010000010001000101
101011111010111111101
101010001010000000101
101010111011111011101
100010100010000010001
111110101110111110101
100000101010001000101
101011101011101011101
101010001000101000101
111010111110101110101
100010000010001000101
101111111010111011111
101000001010001000001
101010111011111111101
100010000000000000001
111111111111111111111
