111111111111111111111
101000000000001000001
101111101111101111101
100000101000100000001
111110101011111111101
100010001000100010001
101111111110101010111
101000000000101000101
101011101111101111101
101000100000001000001
101110111111111110111
100010000000100010001
101111111110101011101
100000000010001000101
101011111011111110101
101000100010000000101
101110111110111111101
100010000000100000001
111011111111111011101
100000000000000010001
111111111111111111111
