1111111111111111111111111111111111111111111111111
1010000000001000000000001000001000001000000010001
1011101111101011111110101110101010111010111010101
1000001010001000100000101000101010000010100010101
1111111010111111101111101011101011111110111110101
1000100000100010001000101000101000100010001000101
1010101111101010111011101110101110101111101011101
1010001000001010100010001000101000100000100010001
1011111011111010111010111011101110101110111110101
1010000010000010001000100010100010101000100010101
1011111010111110101110101010111010111010111010101
1000000010001000100010101010100010000010001010101
1111111111101111111010111010101111111111101010111
1000000010100000000010001010101010000000100010001
1111101010111111111111101010101010111110101111101
1000001000001000000000101010001000001010101000001
1011111111101111101110101010111111101010101011101
1010000000100000101010101010000010000010001010001
1010111110111110101010101011111010111111111011111
1010100000001000101000100010001010100000001000001
1011101111111011101111111110111010101111101011101
1000101000000010000000000000100010101000001000101
1110101011111110111111111010101111101011111011101
1000101010000010001000001010101000001000100010001
1011101011101011101111101011101011111110111110101
1010100010001000101000001000100010001010000000101
1010101110111110101011101110111110101011111111101
1010001000001010100010000010000000100000001000101
1011101011101010111110111111101110111111101011101
1000101010001010100000100000100010001000000010001
1110101110111010111111101110101111101111111110111
1000100000100000100000101000101000101000001000101
1011101111101111101110101110111010101011101011101
1010001000100000001000100010100010100010001010001
1011111010111111111011101010101110101110101011101
1000001010001000100010001010001010100010101010001
1111101011101010101110111011111010111010101010101
1000001010101010100010100010000010100010101010101
1011111010101010111010101111111010111110101010101
1000100000101010001010100010001000000000101000101
1110101111101011101011111010101111111111101111101
1000100010001010101000000010100010000000100010101
1010111010111010101111111010111011111110111010101
1010001010001000100000000010001010000010000000101
1011111011101110111110111110111010111011111110101
1000000010100010100010100000100010001010001000101
1011111110111011101011101111101111101010101111101
1000000000001000001000000000100000001000100000001
1111111111111111111111111111111111111111111111111
