1111111111111111111111111111111111111111111111111
1000100000100000100010000000000000000000001000001
1110101110101110101011111011101111111111101111101
1000100010001010001000001010001000100000100000001
1011101011111011111111101011111010111110111111101
1010001010001000001000101000000010100010001000001
1011111010101110101010101111101110101010111011111
1010000010100000101010100000101000101000100010001
1010111110111111101010111110101011101110101111101
1010100000100000100010001000101010000010100000101
1010101111101110111111101011111010111010111110101
1010101000100010100000001000001010100010000010101
1010101010101011101111111111101010101111101110101
1000101010001000001000100000100010100010001000101
1111101011111111101010111011111110111011111011101
1000001000100000100010001010001000001010000010001
1011111111101110111111101010101011111010111110101
1000000010001010001000000010100010000010001000101
1111111010111011101111111010111110111011101011111
1000000010001000100000100010001010100010101000001
1011101111101010111110111111101010111010101011101
1010001000001010001010000000001010001010101010001
1010111011111110101011111111111011101010101010111
1010100010000000100010000000100010101000101010001
1011101110101111111011111010101010101111101011101
1000101000100010000000000010001000100000101000101
1110101011111011111111111111111110111110101111101
1000101010001000001000101000000010000010101000001
1010101110101011101010101010111011101110101011101
1010100000101000100010101010001000101000100010101
1011111111101111111010101011101110101011111110101
1000000000100000001010100010100010101000000010001
1011111010111111101010101110111010101111101110111
1000101010001000001010100000101010100010101000101
1110101011101011111110111110101011111010101011101
1010101010001010000010100000101000001000101010001
1010101011111010111010111110101111101110101011101
1000101010001000101010000010001010000010101000101
1011101010101111101011111011101010111110101110101
1010001000100000101000001010000010100010100000101
1011101111111010101111101011111010101010111111101
1000000010001010001000101000100010001000100000001
1111101110101011111010101110101111111111111110111
1000101000100010000010101000100010000010000010001
1010101011111110111110101011111011101010111011101
1010101000000000101000100010001000001010001000101
1011101111111111101011111110111111111011101110101
1000000000000000001000000000000000000000001000001
1111111111111111111111111111111111111111111111111
