1111111111111111111111111111111111111111111111111
1000100010000000000000100000000000000000000000001
1110101110111111111010101111111111111111111110101
1010100000101000001010101010001000000010000000101
1010101111101011101010101010101011111010111111101
1010100000001010001010000010100010100010100010001
1010111111111010111111111110111110101110101011101
1010000010000010000000001000100010101000001000101
1011111010111111111111101011101010101111101110101
1000001010100000100010001000001010100000101000101
1111101010101110111010111011111010111110101011101
1000001000100010000010100010001010000010101010101
1011111111111011111010101110101011111010111010101
1010000010000010001010101000101010000010001010001
1010111010101110111010111011101010111111101011111
1000101000101000000010000010001010000000001010001
1011101111101111111111111110111010111111111010101
1010001000101000000000000010100010000000100000101
1011101010101011111111111010101011111110111011101
1010001010001010000000001000101000100010001010001
1010111011101011101011111111101110101011101110101
1010001010001000101010000000100010001000100000101
1011101010111110111010111010111011111110111111111
1000001010101000100010100010001000001010001000001
1111101010101011101110101111101111101011101011101
1000001010101000100000101000101000001000101010101
1011111010101110111110101110101011111110101010101
1010000010000010000010101000101000001000100000101
1110111111111011111011101010101111101011111111101
1000100000001000101000001010101000101000100000001
1011101011111110101111111011101010101010101111101
1010001000000010100010000000101010101010100010001
1011101111111010101010111110101010101110111010111
1000100000001000101010001010001010101000100010001
1110111111111011101011101011111011101011101111101
1000100010001000001000101010001000001000101000001
1011101010101111111111101010101011111110101011111
1000001000101000000000001000100000000000101000001
1111111111101011111111111111101111111111101111101
1000000000001000001000000000100010001000100010101
1011111111101111101111111010111110101010101010101
1010000000000010001000001010100000100010101010101
1011111111111110111011101010101111111110111010101
1000100010000000100010100010100010100010000010101
1010101010111111111010111110101010101011111110101
1010101010000000000010100010101010101000001000001
1010101011111111111110101010111010101011111011111
1010001000000000000000001000000010001000000000001
1111111111111111111111111111111111111111111111111
