111111111111111111111
100010000000100000001
111011111011101111101
101010001000101010001
101010101010101010101
101000101010000010101
101111101111111110101
100010100010000000101
101010111010111111101
101000001000100000101
101111111111101110101
100000000010000010101
101111101011101011101
100010001000101010001
111010111110111010111
101010100000000010101
101010111111111010101
101010100000100010101
101010101110111110101
100010000010000000001
111111111111111111111
