111111111111111111111
101000000000000010001
101110111111101110101
100010100010001000101
111010101010111011101
100010001010000000101
101111111011111111101
100010001000001000001
111010101111101011101
101000101000101000101
101111101110101110101
100000101000101010101
101011101011101010101
101000101000000010101
101110101111111110101
100010101000001000101
111010101011101011101
101010001010101010001
101011111010101010111
100000000010000010001
111111111111111111111
