111111111111111111111
101010001000001000001
101010101010101011101
101010100010101010001
101010111110101011101
101000001000101000101
101111111011101110101
100000000010100010101
111111111110111010101
101000000000001000101
101011111111101111101
100010100000100010101
101110101110101010101
101000100010001010101
101010111011111010101
100010100010000000101
111110101111101111101
100000100000100010001
101111111110111110111
100000000010000000001
111111111111111111111
