111111111111111111111
101000001000001000001
101110101011101011101
100010101000101000101
111011101011101110101
101010001010001000101
101010111010111011101
101010000010000010001
101011111111111110111
101010000010000010001
101010111010111011101
100010001000101010001
101111101111101010101
101000001000101010101
101010111010101010111
101010100010101010001
101110101110101011101
100010001000101000101
111011111011101110101
100000000010000000001
111111111111111111111
