1111111111111111111111111111111111111111111111111
1010000000001010000000100000001000100000000000001
1011101111101010111010101111101010111111111111101
1000101000001010101010001000100010001000001000001
1110101011111010101011111010111111101011101011101
1010001010100000101000100010000000101000100010001
1011111010101111101110101111111110101110111110111
1000100010001000001010101000000000100010001000101
1011101110111110101010101011111111111011101011101
1000101010000000100010101010000000000010001000001
1110101011111111111010101010111111111110111111101
1000101000001000000010101010000000100000101000001
1011101011101011111110101111111110101011101011111
1000101000101000001010100000000000101010001010001
1110101010111111101010111110111111101010101010101
1000101010000000001010100010000010001010100010101
1011101111111111101010101011111011111010111110111
1000100000001000100010001010100010000010100010001
1010111111101010101111111010101110111110101110101
1010000000001010101000001010000000100010101000101
1011111111111010101011101011111111101010101011101
1010000000000010101010001000100010001010100010001
1011101111111010111010111110101010111010111110111
1000100010000010000010000000101000100010000010001
1110111110111111111111111111101111101111111011101
1010000000100010100000100000001000001000101000001
1011111111101010101011101011111111101010101111101
1010000010001000101000001000000000100010001000101
1010101110101110101111111111111110111111101110101
1010100000100010100010000000000010001000101000101
1010111111111010111011111110111111101010101011101
1000100000001010001000100000100000101010101010001
1011111111101010111110101110101110101010101010111
1010000000101010100010001010100010101010101010001
1010111110101011101011111010111010101011101011101
1000100000001000001010000010001010001000101010001
1111111111111111111010111010111011111010101010111
1000000010000000100010001000100010001010101010001
1011111010111110101111101111101110111010101011101
1010100000100000100000101000001000001010001000101
1010101111111011111011101011111111101011111011101
1010001000001000000010001010000000001010000010001
1011111011101111111010111010101111111010101110111
1000001000101000000010100010101000000000101000101
1011101110101111111110101110101011111111111011101
1000101000101000000000101000100010000000001010001
1110101011101011111111101111111110111111101011101
1000100000100000000000100000000000000000100000001
1111111111111111111111111111111111111111111111111
