111111111111111111111
101000000000100010001
101011101110101010111
101000100010001010001
101111111011111011101
100000000010001010001
111111111110101010111
100000000000101010001
101111111010111010101
100010100010100010101
111010101011101111101
100010101010001000001
101110101110111110101
101000100010001000101
101011111011101011101
101000001000101000101
101110111010101010101
100010100010101010101
111010101111101110101
100000100000000000101
111111111111111111111
