111111111111111111111
101000000010000000001
101011101010111011101
101010001010100010001
101110111011101110111
100000100010001010101
111111101110111010101
101000101000100010101
101010101011101010101
100010001000101000101
101111111110111110101
100010000000100010001
111010111011101011111
101010001000001000001
101010111111111011101
101010100000001000101
101010101111101011101
100010101000101010001
101111101010101110101
100000001010000000101
111111111111111111111
