1111111111111111111111111111111111111111111111111
1000100000000000000010000010000000000000100000001
1110101110111111111011101011111011111110101111101
1000101010100000001010001000000010000000101000001
1011101010111110111010111111111110111111111011101
1000100010100010001000101000000010100000001010001
1110111010101010101111101010111010111011101010111
1010001010001010101000000010001010100010000010101
1011101111101011101011111111101110101111111110101
1000100000101010001010001000001000100000001000101
1010111110111010111010101011101011101111101011101
1010000010001010001010101010001010001000001000101
1011111011101011101011101011111011111011111110101
1010100000101000101010001000001000100010000010101
1010101110101110101010101111101110101110111110101
1000101000100000101000100010000010001000100000101
1110101111111111101111111010111011111110101111101
1010100000000000000000000010001010000000100000001
1010111111111111111111101111101010111011111111101
1010001000100000100000100010001010101000000000101
1011101010111010101110111110111010101111111110101
1000101010100010100010001000101010000010000010001
1011101010101011111011101011101011111010101111111
1000100010101010001010100010000000100010100000001
1010111110101110101010111011111111101110111011101
1010001000101000100010000010000000001010101010001
1111101011101011111111111110111111111010101011101
1000101000101000000010000010100010000010001000101
1010101110101111111010111010101010111011101110101
1010001000100000001000100010101010101000101010101
1011111011111011101111101110101010101110101010111
1000100010000010001000001000101000101000100010001
1110101110111110111011111011101111101011101111101
1000100000100010100010001000100000001010001000001
1011111111101110101110101110101111111010111011101
1000100000001000100010100000101000001000100010101
1110101111101011111010111111111011101111101110101
1000101000001010001000100000000010100000001000101
1011101011101011101111111110111110111111111011101
1010001010001000000010000010100000000000100000101
1010111011111111111010111010101111111010111110101
1000101000000000001000100010100000101010100000101
1011101111111010111111101110111110101010101110101
1000001010000010100000100000100010101010001000101
1111101010111111101010111111101010101011111111101
1000100010001000001010000010001000101000001000101
1010111011101011111011111110111111101111101010101
1010000000100000001000000000000000000000100010001
1111111111111111111111111111111111111111111111111
