1111111111111111111111111111111111111111111111111
1000100000001000001000000010000010000010000000101
1110111010111010111010101110111010101011101110101
1010001010000010001010101000100010101000001010001
1011101111111111101010101011101110101111111011101
1000100000100000100010101010001000101000001000001
1011111110101110111110111010111011101010111011111
1000000010001010100000100010000010001010000010001
1110111111111010101111101111111110111011111110101
1000100000001010100000001010000010100000000010101
1010101110101010101111111010111010111111111011101
1010101010100010101000000010100010000000101000001
1010101010111110101110111010101111111110101111101
1010100010001000100000101010100000100000100010001
1011111011101011111111101010111110101111111010111
1010001000100010000010000010100010001000000010001
1010101110111110111010111110101011111010111111101
1000100010000010101000000010001000100010100010001
1011101011111010101111111011111110101111101010111
1000101010000010001000001010001000101000001010101
1110101110111111111011101010101011101011111010101
1000100000101000000010001010100010000010001000101
1011111111101010111110111110111110111110101111101
1000100000100010100010100000100000100000101000001
1110111010101110101110111011101111111110101011101
1010000010101010100000001010000000000000101000101
1011111110101010111111101011111111111111101110101
1000100010100010000010001010000000100000000000101
1110101010111011111010111010111110111111111111101
1000101000100000001010100000101000100000000000101
1011101111111111101010101111101011101111111110101
1010001000000000101010101000001010001000100010101
1010111111101110111010101011111010111010101010101
1010000000001010000010100010000010001010001010101
1011111111111011111110111110111111101011111110101
1000001000000000000010100010000000001010000000101
1111101011101110111110101011111011111010101111111
1000101010101000100010001000001000100010101000001
1010101010101111101011111111101110101110101011101
1010001000101000001000001000001000100010101010101
1011111110101011111111101011111011111010111010101
1000000010101010001000001010000010001010100000101
1011111010101010111011101010111110101010101111101
1010001010101000100010001010000010100010000010001
1011101010101110101110111011111010101111111110111
1000101000100000101000100010001000101000100010001
1110101111111111101111101110101111111010101011101
1000000000000000100000000000100000000010001000001
1111111111111111111111111111111111111111111111111
