1111111111111111111111111111111111111111111111111
1000001000000010000010000000100000000010000000001
1111101110111011101010111110111011111011101111101
1010001000101000001010001010000010000000100010001
1010111011101111111010101011101111111110111010111
1010100010000000001010101000001000000010001010001
1010101110111011101011101111101011111011101011101
1000100010001010001000100000101010001010001000101
1011101011111011101110111010111010111010111110101
1010001000001000101010001010000000100010000010101
1011111011101010101011101011111111101111111011101
1000001000101010100000101010000010001010001000101
1111101110101110111011101011111010111010101110101
1000001010101000100010001000000010001000100010101
1011111010101011111110111111101111101111101010101
1000001000101000000010000000101000101000101010001
1111101011101110111011111110111010101010101011101
1010001000100010101000100010000010001010001000101
1010111111111010101110101011111111111011111111101
1010001000001010001010001010001000100000000010001
1011101011101011101011111010101010101111111010111
1000100010101000100010001000100010101000001000101
1011111110101110101110101110111110101110101111101
1000000000100000101000100010001000100000101000001
1011111110111111111011111011111011111111101011101
1000001000000010000010100010001010000000101010101
1111101011111010111110101110101010101111101010101
1000001000101010100000101000100010100000100010001
1011111110101010111110101010111010111110111110111
1000001000100010100010001010001010100010000010101
1111111011101110101010111110101110101011101110101
1000000010000000101010100010101000101000100010001
1011111111111011101010101011101011101111111011101
1000000000100010001010001000001000100010001000101
1011111110101110111011111111101110101010101010101
1000000010101000101010000000101010101000101010101
1110111110101011101010111110101010101111101011101
1000100000101010001000100010100010101000101010001
1011101111101011101111111010101110101010101010111
1010101000101000100000001010101000101010001010001
1010101011101110111011101010101011111011101011101
1000101000000010001010101010101000100010001000101
1111101111111011101010101010111110101110111110101
1000001000100000100010100010000010001000100010101
1011111010111111111110111011111011111011101110101
1000000010001000000010001010001000001000100010001
1011111111101011111010101011101111101110111011111
1000000000100000001000100000000000100000000000001
1111111111111111111111111111111111111111111111111
