111111111111111111111
100000000010001000001
111111111010111011101
100000100010000010001
101110101111111010111
101000100010001010001
101110111010101110101
100010001000100010101
101011101111111011101
101010000010001010001
101011111110101010101
101000000000101010101
101111111111101010111
101000001000101010001
101011101110101011101
100010101000101010001
111110101011101010101
100000101000100010101
101111101110111110101
100000000000000000101
111111111111111111111
