1111111111111111111111111111111111111111111111111
1000100000000000001000000010001000100000000000001
1110101111111011101110111010101110101111111011111
1010101000000010100000101010100000101010001000001
1010101011111110111111101010111110101010101111101
1000101010100000100000000010000010100010100000101
1011111010101110101111111110111011111010111110101
1010000010101000100000101000101000000010000010001
1010111110101010111110101011101111111110111011101
1000100010001010100000100010000010100010001000101
1111101010111011101111101111101010101011111110101
1000101010100010001010001000001000101000000000101
1010101110101010111010111011111110101111111111101
1010101000101010100010100010001000100010000010001
1010101011101110101010101110101011111010101110111
1010001010001000101000001010101000100010101000101
1011111010111011101111111010101011101110101011101
1000001010000010001000001000100010001000101000101
1011101011111110111011101011111110111011111110101
1010100010001000101010001000100000100010000000101
1010111110101011101011101110101111111010111111101
1010000010101000001000101000100000001000100000001
1011111010101110111110101111111111101011111110111
1000001000100000100000100000100010001010000010001
1111101011111110101110111110101010111011101010101
1010001000100010100010100010001010001000101010101
1010111111101011111010101011111011101110101011101
1010100000101000000010101000100000101000101000101
1010101110101111111011101110111110101011101110101
1010001010101000100010000010000010001000001010001
1011111010101010111110111111101011111111111011101
1000001000100010001000100000101010000000100000001
1010101011111011101011101110101010111110101111111
1010101000001010100010001010101010100010100010001
1110101111101010111110111010111010101110111010111
1000100000101000000010100010000010001000001010001
1011111110101111111010111011111111101011111010101
1000100000100000100010100010000010001000000010101
1010101111111110101110101110101110111111111111101
1010100010001000101000100010100000100000000000101
1010111010101011111011111010111111111110111110101
1010100000101000000010000010001000000000100010001
1010111110111111111110111111101011111111111011101
1010001010100000000000100000001000001000100010001
1011101010101010111111101111111011101010101010111
1010101000101010100000001000001000100010101010101
1010101111101011101111111110101111111110101110101
1000100000001000000000000000100000000000100000001
1111111111111111111111111111111111111111111111111
