111111111111111111111
101000001000000010001
101110101110111010101
100000100010100000101
111111111010111111101
100000100010100010101
101110101110101010101
100010100010001010001
111010111011111010111
100010001000000010101
101111101111111110101
101000100010000000101
101011101110111111101
101010001000100000001
101010101011111110101
101010101010000010101
101010111010111010101
100010000010100010101
111011111110101110101
100000000000100000101
111111111111111111111
