1111111111111111111111111111111111111111111111111
1010000010000000000000100010001000001000000000001
1010111011111011111110101010101110101011111110101
1010101010001010000010001000100000101000100000101
1010101010101010111011111111111111101110101111101
1010101000100010100000000010000000001000100010101
1010101111111110101011111110111111111011111010101
1000101000001000101010000000100000100010001010001
1111101011101011101110111111101110101110101011111
1000001010100010001000100000001000101000101000001
1111101010111110101011111110111010101011111111101
1000001010001000101000000010100010101000001000101
1011111010101011101111111011101111101111101010101
1010000010101010001000001000101000001000101010101
1010111110111011101011111110101011111010101010101
1010100010001000100010000010100000000010101010001
1010101110101110111010111010111111111110101011101
1000100000100010100010001000100000100000001010101
1011111111101110101111101111101110101111111010101
1010000000101000100000101000001010101000100010001
1010111110101010111110101011111010111010101110111
1010001010001010100010100010000010001010001010001
1011101011101011101011111110111011101011111011101
1000001000001010001000000010001000001010000010001
1111111011111010111111111011101111111010111110111
1000001010001000100000101000100000100010000000101
1011101011101111101110101010111110101110111111101
1010001000100000001000001010000010001010101000001
1010111110101111101011111010111111111010101011101
1010001000101000001010000010100010000010100010001
1011101011111011111010111110101010111010101110101
1010001000000010100010100010101000101010100010101
1110101111111110101110101010101111101010111010111
1000100000001000001000101000100000001010001010001
1011111111111011111010111111111111101011101011101
1000000000100010000010100000000000101000001010001
1011111110101110111111101111101110101111111110101
1000001010001010000000100010101000101000000000101
1111101011111011111110111010101111101111111011111
1000001000100010000010000010100000101000001010001
1011111011101010101111111110111110101011101010101
1000100000001000100000000000001000101000101000101
1110101111111111101111111110111010101110101110101
1000101000001000101000000000100010100000100010101
1011101011101010111011111110101111111111111010101
1010001000101010000010001000100000000000001010101
1011111110101011111110101011111111111111101011101
1000000000100010000000100000000000000000100000001
1111111111111111111111111111111111111111111111111
