1111111111111111111111111111111111111111111111111
1010000000001000000010000000000000001000001000001
1010111111101110111010111111111011101110101110111
1000100000100010001000100000000010100000100010001
1111101110111011111111101111111110111111111010101
1010000010100010000000001000000000101000001010101
1010111110101110111111111011111110101011101011101
1010001000101000100000000010000010101010001000001
1010111010101011111011101110111010101010111111101
1010100010101000001000101000100010101010000000001
1010101011101111101110101110101110101011111111111
1000101010001000001000100010101000001010000000001
1011101110111011111111111010101011111010111110101
1000100000100000001000100010100010000010100010101
1110111111101111101010101110111110111111101011101
1010100000101000001010001000100010000000101000101
1010101010101011111011111011101011111110101110101
1010101010101000100000001010001010000000101010001
1010101010101110111011101010101110111111101011101
1010101010100010001000101000101000100000001000101
1010101011111011101110101111101011111110111010101
1010101000000010101000101000001000001000100010001
1010111111111010101110101111101111101011111111101
1010000000001000100010101000100010101000000000101
1011111111101111111010101010111010101111111110101
1000001000100000000010100010001010100000000010101
1011111010111111111111101111101010111111111010111
1000000010000000000000100000101010001000001010001
1011111111111110111110111111101010111011101011101
1000101000100010001000000000001000100010101000101
1110101010101011101111111111111110101110101110101
1010101010101000001000001000001000100010100010001
1010101010101111111011101011101111111010101011101
1010100010100000100000101000100000000000101010101
1010111110111110101111101110111111111111101010101
1010001000000010001000001000101000001000001000101
1011101011111011111011101011101011101011111011101
1000001010001000001010001010000000101010000010001
1011111010101111111011111011111111101011111110111
1000100010100000001000000010000000101010001000101
1110101110111111101111111110111110101010101011101
1000100000000000100000000000100010101000100010001
1011111111111111111011111110101110101111111111101
1000001000001000001010000010100000100000100000101
1111101011101011101010111010101111111010101010101
1010001010100010001010001000101000000010101010101
1010111010111110111111101111101111101110111010101
1000000010000000000000001000000000001000000010001
1111111111111111111111111111111111111111111111111
