111111111111111111111
101000000000000010001
101011111111101110101
101000000000101000101
101011111110101011101
101000100000101010101
101011101111101010101
101010001000101010101
101110111010111010101
100010001010000000101
111010101011111111101
101010100000100010001
101010111110101010101
101010100010001010101
101011101011111010111
101010001000001010001
101010111111101111101
100010100000101000001
101110101110101011101
100000100010000010001
111111111111111111111
