1111111111111111111111111111111111111111111111111
1000000010000000101000000000100000000000001000101
1111111011111010101011101011101111111011101010101
1000001000000010100010101010000000100010100010001
1110101111111110101110101110111111101110111111101
1000101010000010101000100000001000001000001000101
1011101010111010101011111111111011111111101010101
1010000010100010101010000000000010000000100010101
1011111010101110101010111110111110101110111010101
1010001010100000100010000010100010100010001010101
1010101110111111111111111010101011101011101110101
1000100010000000000000100010101000101010000000101
1111101011111111111110101111101110101011111111101
1000101000001000100010100000000010101000001000001
1010111010111010101010111111111110101111101011111
1010000010100010101010000000100000100010100010001
1011111110101110101011111110101111111010111110101
1000001000100010001000100000100000101000000010101
1011101011111011111010101111111110101111111010101
1010001000100010001010100000000000101000100010101
1010111111101110101010111111111111101010101110101
1010000000001000101010001000100000000010001000101
1011111111111011101110101110101111111111111011101
1010000010001010100000101000100010000010001000101
1010111011101010111111101011111010111010101110101
1010101010001010100010001000001000101000100000101
1010101010101010101010111111101111101111111111101
1010100010101010001000100010001000000000100000101
1010101110101011111011101010111011101111101011101
1000101000101010001000001000100010101000001000001
1111101011111010101110111111101110101011111111111
1000100010000010100010100000101000100010000000001
1011101110111010111011101110101110111111101111101
1000001000100010101000100010101000100000001000101
1011111011101110101110111010101010101011111010111
1000001010000010100010000010100010101000000010001
1111101011111110101111111110111110101111111111101
1000101010000000100000000010001000101000100010001
1010111010111111101111101111101011111010101010101
1010000010000010001000001000101000000010001010101
1011111111111011111011111010101111111111111010111
1010000000001000001000100010001000000010000010001
1010111111101111101010101111101011101110111111101
1000000010000000101010101000101010100010100000101
1011111110111110101010101010111010111010101110101
1000100000100010101010100010000010001000100010101
1110101111101011101110111111111111101111111010101
1000100000001000000000000000000000000000000010001
1111111111111111111111111111111111111111111111111
