1111111111111111111111111111111111111111111111111
1010000000100000100000000010000010000000100000001
1010111110111010101011111110101010101110101111101
1010100010000010101000000000101010100010001000001
1010101011111110101111111111101011111011111011111
1010101000001000101000001010001010001000101010001
1010101111101111101110101010111010101110101011101
1010001000101000101000100010001000100000100010001
1010111110101010101011111011101111111111101110101
1010100000100010101000001000100000100000100010101
1010101010111110101111101111111110101110111010101
1010101010000010100000001000000010100010101000101
1010101011111110111111101011111010111010101111101
1010101000000010001000001000001010000010100000001
1010111111101011101011111111101011111010111011111
1010000000101000100010000000101010001010001010001
1011111110111011111111101110101010101111101010111
1000001010001000100000001000101000100000101010001
1111101011101010101110111111101111111110101011101
1010001010001010001000100000001000001010001000101
1010111010111011111010101111111011101011111110101
1010100010001000100010101000001000101000000010101
1010101111101111101111101011101110101011111110101
1010101000101000100010001010001000101000000000101
1010101010101010111010111010111011101011111111101
1010101010001010000010001010000010001000100000001
1010101011111011111011101011111110111110111111101
1010101010000010001000100000000010000010000010001
1010101010111110101111111111111011111011111010101
1010101000100000100000000000101000101000100010101
1010101011101111111111111110101110101110101110101
1010101010001000100000000010100000100010100000101
1010101010111011101110111110101111101010111111111
1010100010001000000010001000101000001010000000001
1010101111101111111111101011101011111111101111101
1000100010001000100000100010101010001000100010001
1011111110111010101110101110101010101010111110101
1000000010000010101000101000100010100010000010101
1111111011111110101011101110111010111111111010101
1000001000100010001010100010100010001000001000101
1010101110101010111010111010101111101010111111101
1010101000101010001010100010001000001010001000001
1110101011101010111010101111111011111011101011111
1000101000001010100010100000001010001010101000101
1011111111111010101110111111101010111010101110101
1000100000100010100010000000100010001000100010101
1010101110101111111010111110111110101110111010101
1010000010000000000010000010000000100000001000001
1111111111111111111111111111111111111111111111111
