1111111111111111111111111111111111111111111111111
1000000000001000000000000010000000001000000000101
1111111111101011111110101011101110111011101110101
1000001000001010000010101000001000100010001010101
1011101011111110111011101011111110101110111010101
1010001010000000101010001010000010101000100000101
1010111010111111101010111010111011101011111110101
1010000010100010001010100010100010001000100010001
1011111110101010101010111110101110111110101011101
1010000010001010101010000000100000100010001000101
1010111011111011101010111111111111101111111110101
1010001000000010001010000000001000100000100010101
1011101111111110101011111111101010111010101010101
1000001000001000101000000010001010100010001010101
1111111011101011111111111010111010101111111110111
1000000010101010000000001010100010001000000010001
1111111010101010101111101010101111111011111011101
1000000010001000100010001010100000000010001000101
1011111110111110111011111010111111111110101011101
1010001000100010001000001010000000000000101010001
1010111011101011111011101011111111111111101010111
1010000000001000001000101010000010000000100010001
1011111111111111101111101010111011101110111011101
1010000000000000100000001010001000100010000000101
1010111111111110101111101010101110111111111111101
1000100000100000101000101010101010001000100000001
1011101110101110111010111010101011101010101111101
1010101000100010100010000010101000100010101000001
1010101011101010101111111110101110111110101111101
1000101010001010100010000000100010001000101000101
1110101011111011111011111110111010101011101010101
1000101000001000001010000010101010101000101010101
1111101111101111101010111010101010101110101010101
1000001000001000001010001010001010100010100010101
1011111011111010111011101011111011111010111110101
1010001010000010100010001010000010000010001000101
1011101011101110101110111010111110111111101011111
1000100000001010100000100010001000000000001000001
1110111111111010111111101111101110111111111111101
1000100000001000100000100000100010000000100000101
1011101111101111101011111110111011111110101110101
1000001000101000001000100010000010100010001000101
1011111110101011111110101011111110101011111011101
1010000000101000100010001000001000001010001000101
1010101110101110101011111111101011111010101110101
1010100010101000101000000000101000101000100010101
1011111010101011111110111110101110101111111010101
1000000010100000000000100000100000000000001000001
1111111111111111111111111111111111111111111111111
