1111111111111111111111111111111111111111111111111
1010000000100000000000100000001000000000100010001
1010111110101111111110101111101111111010101110101
1010001000101000000010001000100000100010100000101
1011101011101111101011111110111110101110111111101
1010001000101000001010000000000010001000100000101
1010111110101011111110101111111111111011101110101
1000100000101010000010101000000000000010001000001
1111101111101010111010101011111111111110111111101
1000101000001010001000100010000000100010000000101
1010101111101011101111111110111110101011111110101
1010101000001000101000000000100010001010000010101
1011101011111011101111101111111011111010111010101
1000101010000000000000001010000010000010001010101
1010101010111111111111111010101010111110101010111
1010101010100010000010000000101010001000101010001
1110101011101010111010111111101111101111101011101
1000101000001000101010100010001000101000001010001
1011101011111111101010111010101010101011111010101
1000001010100000001010100010101010001000101010101
1011111010101110111010101110101011111010101010111
1000001010001000100010101000101000100010100010001
1111101011111010101110101011101110111010101111101
1010001000000010101010101010000010001010100000101
1010111111111110101010101011111011101110111110101
1010000010000010101010001000001000100010000010101
1011111010111011101011101111101110111011111010101
1000100010100010001000000000100010001000100010001
1010101110101110111011111111111011111110101111101
1010100000101000100010001000000010000010001010001
1010111111101010111110101010111110111011111010111
1010001000101010100000100010100000100010000010101
1110101110101110101011111111101111101011101010101
1000100000100000101010000010000000101010001010101
1011111011111111101110111010111111101010111010101
1000100010000000000000100010001000001000100010101
1010111110111111111110101111101011111111101110101
1010000000101000000010101000001010000010000010001
1111111011101011111011101011111010111010111111101
1000001010001010001000001000100010001010001000101
1011101010101011101111101110101110101111101010101
1000101000101010000010001010100010100000001010001
1110101111111010111110111010111011111111111011111
1000100000000010001000100010001000000010001010001
1011101111111110101011101111101111111010101011101
1000101000001000100000001000101000001010101000101
1010111011101111111111111010101111101010101110101
1010000000100000000000000010000000001000100000001
1111111111111111111111111111111111111111111111111
