1111111111111111111111111111111111111111111111111
1000100000000000100000001000001000000010000000001
1110101110111110101111101010111011111010111111101
1000100010001000101000101010000010001000101000101
1011111011101011101010101110111111101111101010101
1000101000101000001010100010000000100000001010101
1110101110101111111010111011111110101111101010101
1010100010100000100010000010000000100010001010001
1010101110111110111111111011111011111010111011111
1010100000000010000000001000001000000010001000001
1010111111101111111111101111101111111111111111101
1000100010001000001000001000100010000000001000001
1011101010111011101011111010111010111111101011111
1000001010100010100010001010001010100000100010001
1111111011101110111110101011101010101110101110101
1000001000100010000010100010100010001010101000101
1111101110111011101110111110111110111010101011101
1000100010001000100000100010000010001010101000101
1010101111101010101111101110101111101010111011101
1010001000001010101000000000100000101010001010001
1011101011111110101111111111111110101011101010111
1010001010000000100000100000000010000000101010001
1011111011111011111110101111111011111110101011101
1000000010000010000010001000001000000010100000101
1011111110111110101111111011101111111010111111101
1000000000100010100000000000100010001010100000101
1111111111101110111111111110111010111010101110101
1000000010000010000000101000100000100010100010001
1111111010111011111110101011111111101111111011101
1000001010001000000010101010001000001000000010101
1011101011101011111010101010101011111110111110101
1000100000101000100010001000101000000000100000001
1010111011101110111111101111101111111111101111111
1010001010001010100000100010100010001000100010001
1111101010111010101011111010111010101010111010101
1000001010100010101000001010001010100010100010101
1011111010111010101110101011101010111110101110101
1000001010000010100010101000001000100000101000101
1011101111111010111010111111101111101011101011111
1000100000100010100010000010100000101010001010001
1110111110101110101111101010111011101010111010101
1000100010001010001000001000100010001010100000101
1011101111111011111011111110101110111110111111101
1010001000000010001000001010100010000010000000101
1011101010111010101111101010111011111011111110101
1000100010001010100010001000001000001000000000101
1110111111101011111010111111111111101111111111101
1000000000001000000010000000000000000000000000001
1111111111111111111111111111111111111111111111111
