1111111111111111111111111111111111111111111111111
1000100000001000100010000000001000000010000000101
1110101011101010101010111111101111101010111110101
1010101010001010001010000010000000001000100010101
1010111010111011111011111011101111111111101010101
1010001010000010001000001000101000100000001010001
1011101011111110111111101010111010101111111011101
1010001010001000000000001010001010001000100010101
1010111010111011111111111011101011111010101110101
1010000010001010000000001000100010000010101000001
1011111110101010111111101110111111111011101011111
1000000000101010000010000010100000001010001000001
1111101111101011111010111110101111101010111111111
1000101000001000100010000010001000101010000000001
1010111011101110111111111010111110101011111111101
1010100010101010001000000010100010001000001000001
1010101110101011101011111110101011101011101011101
1010001000101000101010000010101000100010001010101
1011111110101110101010111010101110111111111010101
1010000010000000101000101000100010001000001010001
1010111011111110101011101111111011101011101010111
1010001000001000101000100010001000101010101010001
1011101111101111101110101010101110101010101011101
1000101000100000101010101000100010100010101000101
1010101110111110101010101111111110111110101010101
1010100000001010101000101000000010100010101010101
1110111111101010101011101011111010101010101010111
1000000000101010001010000010000010101000101010001
1011111111101011111011111010111110101110101011101
1000000000001000001010001010100000100010101010001
1011111111111010101010101110101111111011101010101
1000100000001010101000100010101000000010001010101
1110101111101110101111111010101110101110111010101
1010101000001000100010000010100010100010100010101
1010101110111011111011111010111010111010101110101
1000100010000010000000001000100010100010101000101
1011111011111011111111101111101111101110101011101
1010001010001010001000101000100000100010101000101
1010101010101110101010101010101110111010111110101
1000101000100000101010100010100010001010000000101
1111101110111111101010111110111011101011111111101
1000100010100000100010000010101010101000001000101
1010111010111010111111111010101010101011111010101
1010001010000010000000101010100000101000001010001
1111101011111111111110101010111011101011101011111
1000001000001000000010001010001010001000101010001
1011111111101011111011111011101110111110101011101
1000000000000010000000000010000000100000100000001
1111111111111111111111111111111111111111111111111
