111111111111111111111
100010000010000000001
111011101011101111101
101000101000001010001
101110101111111010111
100010001000100000101
101011111010101111101
101000001010001000001
101110101011111011101
100010101010000010101
111010111011101110101
100010100010001000001
101110101110111011111
101010001000100010001
101011111011101110101
100010000010101000101
111011101110101110101
100010001000101000101
101110111011101011101
100000100000000010001
111111111111111111111
