1111111111111111111111111111111111111111111111111
1000100000001000000010001000000000100010000000001
1110111011101010111010101111101110111010111110101
1010000010001010101010100000101010001010001010101
1011111110111010101010111110101011101011101010111
1000100010001010100000100000001000101000000010001
1010101011101010111011111111111110101111111111101
1010001000101010001010000000000010000000000000101
1011111011101011101110111111111011111111111110101
1000001000101010100000000000001000000000000010001
1111111110101010111111111111111111111111111011101
1000100010101010001000100000000000001000000010001
1010101010101010101110101111111111101011111110111
1010001000101010100000100000100000100010000010101
1011101111101010111110111110101111111111101010101
1000101000101000100000100010100000000000001010101
1010111010101111101111101010111110111111111010101
1010000010001000101000001010100000100000000010101
1011111111111010101110101110101011111111111010101
1000000010001010100000101000101010001000001010001
1111111010111010111110111011101110101011101111101
1000001010000010000010100010000000100000100000101
1011101011111110101110101110111111111110111011101
1000100010000010101000100010100000100010001010001
1110111110111011101011111010101011101011111010111
1000100000101000100010001010101010001000000010101
1011101111101110111010101010101010111111111010101
1010001000001010001010100010101010001000101010001
1010111011101011101110111110101111101010101011101
1000100010001000100010100000101000001010001010001
1111111010111011111010111011101011111010111010111
1000000010100000100010001000001010000010100010101
1011111110101110101110101011111011101110101110101
1010000000101000101000101010001010001000101010101
1011101111111011101111101110101010111111101010101
1000100000100010001000100010100010000000000010001
1110111110101010111010111010111110111111101111101
1000100000001010100010000010001000100000101000001
1011111111111110111011111111101111101110111011111
1000000010000000100010001000100000101010000010001
1011111010111111101110101010101110101011111111101
1000001000100000001000101010100010001000001000101
1111101111101111101011101010111011111010101010101
1010001000000000101000100010101010000010100010001
1010111111111010111011111110101010111110111111101
1010000010001010000010000000100010100000100000101
1011111010101111111110111111101111101111101011101
1000000000100000000000100000000000001000001000001
1111111111111111111111111111111111111111111111111
