1111111111111111111111111111111111111111111111111
1000001000001000000000001000000000100010001000001
1111101110101011111110101111101110101010101111101
1010001000101010000000100010001010001000100000001
1010111011101010111111111010111011111111111111101
1000100010001010000000101010001000001000000000101
1011101110111011111110101011101010101011111010101
1000100010101000101000101000101010101000100010101
1110111010101110101011101110101010101111101111101
1000100010100000001000100000101010100010001000001
1011101110111111111110101111101110111010111011111
1000101010000000001000100010001000100010001000101
1110101011111111101011111010101011111011101110101
1010001000001000100010001010101010001000000010101
1011111011101010111111101011101010101111111010101
1000100000101010000000101010001000100010000010101
1011101110111011101110101010111111111010111110101
1010001010001010101010101010001000001010100010001
1010111011101010101010101010101011101011101011101
1000100000100000101000001010100010001010001000001
1011101011111110101110111010111110111010111111111
1000101010000010100010100010100010101000100000001
1110101110111011111010101111101010101011111110101
1010001000100000000010100010001000101000000010101
1011101011101111111111111010111111101111111010111
1010001010101000000000000010100010000010000010001
1010111010101011111111111110111010111010111110101
1010100010101010000010000000100010001010001000101
1010101110101010111010101111101111101011101111101
1000101000101000100010101000000000101000100010001
1111101011101111101111101011111010101011111010101
1000101010001000100000001010100010101000001010101
1010101010111110111111111010101110101111101010101
1010101010000010000000001000100010101000101010101
1010101011111011101110111110111010101010101010111
1010001000001000001000100010100010100010101010001
1011111111101110111111101010101110111110101010101
1000100010001000100000001010100010000010101010101
1010101010111011101111111010111011111110101011101
1010101000100010101000000010001000000010101000101
1010101111101110101011111111101111111010101110101
1010100010001000101010000000100010001010100010101
1010101010111110101010111110111011101010101110101
1010101000000010101000100000100010001000100010001
1010101111111010101111101110101110101111111011101
1010100010001000100000101000100000100000001000001
1010111110101111111110101111111111111111101111111
1010000000100000000000100000000000000000000000001
1111111111111111111111111111111111111111111111111
