111111111111111111111
100010100000000000001
111010101111111111101
100010001000100000001
101111101110101111101
100000100000101000101
111110101111101011101
101000101000001000001
101011101011111011111
101010101010100010001
101010101010101110101
100010101010001000101
101110101010111010101
101000101010001010101
101010101011101110111
101010001010100010001
101011111010111011101
101000001010001000101
101111111010101110101
100000000010100000001
111111111111111111111
