111111111111111111111
101000000000000000001
101111111111111010101
101000000000001010101
101011111111101110101
100010100000001000101
111110101111111011111
100000100010000000001
101011111011111111101
101010001010000000101
101010101010111110101
101000101000100010001
111111101111101011101
100000001000001010001
101111101011111010111
101000101010000010101
101010111010111110101
100010001010000000101
101111101011111111101
100000100000000000001
111111111111111111111
