1111111111111111111111111111111111111111111111111
1010001010000010001000000010000010000000000000001
1010101010101010101011101010111110111011111111101
1010101000101000101000101000100000100010000000001
1010101111101111101111101011101111101111101111111
1000100010001000100000001010001000100000100010001
1111111010111010111110111110111010111110111010101
1010000010001010000010100010001010000010001010101
1010111111101011101010101011101111101011101010101
1010000010001000101010101000100000101000101000101
1011111010101111101110101110111110101110101111101
1000001010101000100010101010000010101000101000101
1010111010111010111010101011101110101011101011101
1010100010001010001000101000100000001010001000001
1010101110101011101111101110111111111110111110111
1010101010101010100000101000100000000010100010001
1011101010101010111110101010101111111010101011101
1000101000100000100010100010100010001010001000101
1010101110111111101010111110111011101010111110111
1010100010000010001010000000100010001010100010001
1010111011111110111011101111101110111010101011101
1010000010000010001000101000001000100010001000101
1011111110111010101110111011111010101110111111101
1000000010001010101000100010000010101010100000001
1111111011101011101011101110101110101010101111101
1000001000001000101000001000100010101010100000101
1010111111111110101111111110111010101010111110111
1010000000100000100000000010001010101010100010001
1011111110101111101111111011111011101010101011101
1010000010001000100000100010000010001000001010001
1010101111111010111111101110111010111111111010111
1010101000000010100000001000101010100000001010001
1010101011101110101111111010101010111011101111101
1010100010001010001000001010100010000010101000001
1011111010111011111110101010101111111110101011101
1010001010101000000000101010100000001000001010001
1010101110101011111011101110111111111011111010111
1000101000101010001010001000100000001010000010001
1111101011101010101011101010101111101011101111101
1010001010000000101000101010101000101000100010101
1010111011101111111110101011101010101110111010101
1010101000101000000010101000100010100010000010001
1010101010111011111010101110111110101011111110111
1000100010100010001000100000000010101010000010001
1011111110101110101111111011111110101010101111101
1000000000100010101000001010001000101010100000101
1111111111101010101011101110101011101110111110101
1000000000001000100000100000100000100000000010001
1111111111111111111111111111111111111111111111111
