1111111111111111111111111111111111111111111111111
1010001000000000001000001000100010000000000000001
1010111011101111101011101010101011111110111110111
1010000010001000100010001010101000000010100010001
1010111110111010111110111010101111111011101011101
1010100000100010100010001010100000001000001000101
1011101111111010111011101010101111101111111110101
1000001000000010000000101010100000101000000000101
1111111110111111111110101010101111101011111111101
1000000010001000100000100010101000001000001000001
1011101011101010101111111110101011111111101110101
1000101000001010101000000010101010000010001000101
1111101111111010101111101010111010101110111011101
1000001000000010100000001010000010100010000010001
1011111111111010111111111011111110111011111110111
1010000000001010001000001010000010100010100010101
1011101011101010111011101010111110101010101010101
1000101000101010100010100010100000101000101010001
1010111010101010101110111110101111101111101011101
1010001010100010101000000000100000100000101000101
1011101110111111101111111011111110111110101110101
1010100010000000001000000010000010000010001000101
1010111010111111111011111010111011111011111011101
1000001010100000000000100010101000001010001010001
1111101010111111111110101110101110111010111010111
1000001010000000000000100010100010001010001000101
1011111011111110111111111110101111101010101111101
1000001010000010100000000000100000100010100000001
1111111010101110101111111111111011111110111011101
1000000010100000101000001000001000001000101010001
1011111110111111101110101011101011101011101010111
1010000010001000100000101000101000101010001010001
1010101111101110111111101110101110101011101011101
1010100000100000100000100010100010100010001000101
1011111110111110101110111010111011101110101110111
1000000010000000100010000010100000100010100010001
1011111011111111111011111110111110111010111011101
1010000010000000001010001000001010101010001000101
1110101110111110101010101111101010101011101011101
1000101000100010101000100000001000100000001010001
1011101011111010111111111111111011101111111110101
1010001000000010001000000000100010000010001000101
1011111111111011101010111011101110111110101011111
1010000010000010100010001010001010100000101000001
1010101110111110111111101010111010101111101011101
1010100010100000100010101010100000100010001000101
1010111010111010101010101110111111111010111111101
1000001000000010001000100000000000000010000000001
1111111111111111111111111111111111111111111111111
