1111111111111111111111111111111111111111111111111
1000001000100000001000000010000000000000100010001
1111101010111011101011111010101111111110101011101
1000100010000010001000100010100010001000101000101
1010111111111110111011101110111011101011101110101
1010000000001010001010001000101010001010001000101
1111111011101011101010101011101010101010111011101
1000000010001000101010101010001010101010101010001
1011111110111110101010101010111010111010101010101
1000000010000000101010101010001010000010100010101
1011111011111110101010111010101010111110101110101
1000100010001000101010001010101010000000100000101
1110101110111011101011101011101011111111111111101
1000101000100010001010001000101000100000001000001
1011101011101110111010111110101110101111101111101
1010001010000010100010100000100010001000100000101
1010111010111110101110101111101111111010111010101
1010001010100000100010001000001000000010001010101
1011101010101111111011111110111011111111101010111
1000101000101000101010000000100010000010101010001
1110101011101010101010111110101010111010101111101
1000101000100010100000100000101010001010001000101
1011101111111110111011111111101110111010111010101
1000100000000010001010001000100000100010000010101
1110111111101111101110101010111111101111111110101
1010100000100000101000100010000000101000001000101
1010111110111010101011111111111110101010111011101
1010000000001010100010000000100000101010001010001
1011111111101010111110101111101111101111101011101
1000000010001010001000101000001000100000101010001
1011111010111011111010111011111011101110101010111
1010000010100010000010000010001000101000101010001
1110111010101110111111111110111010101011101010101
1000100010100010000010000000100010101000100010101
1010111110111011111010101110101110101110101110101
1010100010100010000010100010100010001010101000101
1011101010101110111110111011111011111010101111101
1000101000101000100010101010000010000010100010001
1110101111101011111010101010111110101010111010101
1000101010001000001010101010100010101010001010101
1011101010111111101010101010101011101111101010101
1000001010000010001010101000001000100010001000101
1011111011111010111010101111111110111010111111111
1000001000001010100010000010001000000010000000001
1111101010111010101011101110101111111111111111101
1010001010001010101000001000101000100010000010001
1010111111101010111111111011101010101010111010101
1000000000001000000000000010000010001000100000101
1111111111111111111111111111111111111111111111111
