111111111111111111111
101000000000000010001
101111111110111010101
100000100000101010101
111110101111101010101
101000101000000000101
101011101111111111101
101000100010001000001
101110101010101110111
100000101000100010101
101111111111111010101
101000100000100010001
101010101110101111101
100010101000100000101
111110101011101110101
101000101010000010101
101011101011111110111
101010001010000010001
101010111010111011101
100000100000100000001
111111111111111111111
