1111111111111111111111111111111111111111111111111
1000100000000010000010000010000000100000001000101
1110111011111010111010111110111110101110101010101
1000100010001000100010000000000010100010100010101
1011101111101111101110111111111110111010111110101
1010001000000010101000100010000010001010001000001
1010111011111010101011101110111010101011101111101
1000100010100010101010000010100000101000100010001
1111101110101110101011101010111111101110111011111
1000001000000000101000101010001000000010101000001
1010111011111110101110101011101111111110101111101
1010100010001000101000101000101000000010100000101
1110101110101111101011111011101011111010101111101
1000100010100000001000001000101000101000001000001
1011111010111111111111101110101110101111111011101
1010000010101000100000101000101000100000100010001
1011111110101010101110101011101011111110101110111
1000100000100010001010001000101010001000101010001
1010101111101111111011111110101010101011101011101
1010001010001000100000000000100000100010001000101
1011111010111010111110111110111111111110111010101
1010000010001010000010001010001000001000101010001
1010111111101011111010101011101011101011101011111
1010000000000010001010101000001000101000100010001
1011111011111110111011101011111110101110101110101
1000001010000010100010001010000000101000100000101
1111101110111010101110111010111111101011111111101
1000100010101010000000100010100000100010000000001
1010111010101011111011111010111011111110111111111
1010001000100010001010001010001010000010101000001
1010111111101110101110101111101010101110101010111
1010100000101000101000101000101000100000100010001
1010101110101010101011101010101011111111111011101
1010001010001010100010001010101010001000001000101
1011111011111110111110111010101010101110101111101
1000001000000000100000000010001000100000100000001
1111101110111111111111111111111111111111111111101
1000100010000000000010000000100000100000000010001
1010111011111011111010111010111010101111111010111
1010001000001000001010100010001010101000100010101
1010101111101110111011101111101110101010101110101
1010101000001000100010001000101000100010100000101
1010101011111111101110111010101011111110111111101
1010101000001000100010000010100010000000100000101
1010111111101010111010111110111110111111101010101
1010001000101010001010100010000010100000001010001
1011101010101011101010101011111010111111111011101
1000100010000010000010001000001000000000000010001
1111111111111111111111111111111111111111111111111
