1111111111111111111111111111111111111111111111111
1010000000100000001000000000001000000000100000001
1011111011101110101011111011101110111110111010101
1000001000001000101010000010100010000010001010101
1111101111111011101010111110111011111011101110101
1000001000000010101010100000001010000010100000101
1011111011111110101110101110111010111110111111101
1000001010000000100000101000100010101000000010001
1111101010101110111111101011101110101010111110111
1000100010101000100000001000101000101010000010101
1011111111101011101111111110101110101011111010101
1010000000001010001000001010100010100000101010101
1010111011111010111011101010111010111110101010101
1010101010000000100010101000101010000010001010001
1010101011111111101110101011101011101011101011101
1000101010000000000010101000001000101000101000101
1011101010111111111010101011111110111110101110101
1010001010100000001000101010000010100000100010101
1010111010101111101111101010101110101111111110101
1010001000100010100010001010100010100000000010001
1010101111111010111010111110111010101111111011111
1010100000001010000000100000100010100010001000001
1010111111101011111111101111101010111010101111101
1010001000001000001000101000101010100010101000001
1011111011101111101010101010101010111110101011101
1000000010101000100010000010101010100010100010101
1111111110101110111111101111101010101010111110101
1000001000100000101000101000001010101000100010101
1011101110111110101010101011111110101111101010101
1000100010000010101010101000001000100000101000101
1110111010111010101010111011101011111110101111101
1000100000101010001010001010001010000000100010001
1011111111101011101011101110101010101111111010111
1000000000100010001010001000101010100010000010101
1011111110111110111011101011111011111010101110101
1000100010000010001000100010001010000010100010001
1110111011111011101110111110101010111110111011101
1010000000001000101010000000100010001010001000101
1011111111101110101011111111111111101011101011101
1000000000101000101000000010000000101000001000001
1110111111101011101111101010111010101011111111111
1000100010001000100000101000001010001010000000001
1011101010111110111110111111101011111010101111101
1000001010001010000000100000101010100010101000101
1011111011101011111111101110111010101111101011101
1000001000101000100000100010000010101000001000001
1111101011101010111010111011111110101011111011111
1000001000000010000010000010000000000010000000001
1111111111111111111111111111111111111111111111111
