1111111111111111111111111111111111111111111111111
1010001000001000100010001010000010000000000000101
1010101011101010101010101010101011111010111110101
1000101010101010001000100010101000001010000010101
1111101010101011111111111010101111101111111010101
1000100010101000100000001010100000100000100010001
1011111110101010111111101010111110111110101111101
1000001000101010000000100010000010001010100000101
1111101010101110111110111111111011101010101110101
1000100010100010000010000000000000101000101000101
1010101110111011111111111111111111101011111011111
1010101000001000100000001000000000101010001000001
1010111011101110101111101011111110101010101111101
1010000010000010001000001000100010001000100000101
1011111111111111111011111010101111111111111110101
1000100010000010001010100010100000100010001000001
1010101010111010101010101110111110101010101011111
1010101010001000100010000010000010101000100010001
1110101011101111111110111111111010101111111110101
1000101000001000000000100000001010000000001000101
1011101111111011111111101111101011111110111011101
1000100000001000000000101000101000000010100010001
1110111111101111111111101010101110111011101110111
1000000010100010000010001010100010001000101010001
1011111010111010111010111010111011101110101011101
1000001000001010001010001010001010101010100010001
1011101111101011101011101011101010101010111010101
1000101000101000101000001010100010000010000010101
1110101011101110101111111010111110111111101110101
1010101010001010001000001000001000001000100010101
1010101010111011111011111111101011111010111110101
1010101000100000000000000000101010100010000000101
1010101011111111111111101111101010101111111111101
1000101010000010000000101000001000100000100000101
1011101010111010111110101011111111111110101110101
1010101000101010001010001010000000100000101010001
1010101111101011101011101010101110101111101011111
1000101000000010001000001010101000001010001000001
1110101111111010111011111010101111111010111010101
1010100010001000101010001010100000001000001010101
1010111010101111101010111010111111101111101010111
1010101000100010000000100010001000100010001010001
1010101111111011111111101111111010111011101111101
1010100000001010000010001000001010001000100010001
1010111110101010111010111110101011101010111010101
1010000010101010001010100010101010001010001000101
1011111011101011101010101010101010111111101111101
1000000000001000001000001000100010000000001000001
1111111111111111111111111111111111111111111111111
