1111111111111111111111111111111111111111111111111
1010001000100000000010000010000000100000000010001
1010101110101111101010111110111110101011111011101
1000100010001000001010100000001000101000100010001
1111111011111011111010101111111011101110101110111
1000001000001010001010000010000010001010101010001
1011111111101010101011111010111010111010101010101
1000000000100010101000100010001010100010101000101
1011111110111110111110111011101110101110101111101
1000100000001000000010001010100010101000100010001
1110101111101111111011101010111010101011111010111
1010101000000000001000101000001000001010001010001
1010101111111111101110101110111111111010111011101
1000100000000010000000100010100010000010001000101
1011111111111011111110111011101010111110101110101
1000100000000010001000001000101010001000100010101
1110101110111110101111111110101011101011111010101
1000100010100000100010000010001010001000001010001
1011111011101111111010111011111010101111101011101
1010100010001000100010001000101010101000101000101
1010101110111110101110111010101010101010101110101
1000100010100000100000100010001010101010101010001
1111111010111011111111101111101010111010101011111
1000001010001000000000101000001010000010100010001
1011101011101111111010101111111011111110111010101
1000100000100000001010101000001000000000101010101
1110111111111111101011101011101111111111101010101
1000100000001010001000100000100000001000001000101
1010101110101010111010111111101011111011101111101
1010100010100010100010100000001010001010100000001
1011101110111110111110101011111110101010111111111
1010001000100010000010101010000000101000100000001
1010111011101011111010101010111111101110111110101
1010001000101000100010101010001000100010100000101
1011101110101110101110101111101110111010101111101
1000101000100010001000100000100010001010100000101
1110101011111011111010111110111011101010111110101
1000101000100010001010000010000010001000100000101
1010101110101110101010111111111110111111101111101
1010100010001000101010100000000010100000000010101
1010111011111011101010101011111010101111111010101
1010001010000010001010001000100010000010001010001
1011101011111010111011111110111011111010101010111
1000101000100010100000001010001010001010100010101
1010111110101110101111101011101010101110111110101
1010100010101010101000100000101010100000100010101
1010101010101010111010111111101010111111101110101
1010001000001000000010000000001000100000000000001
1111111111111111111111111111111111111111111111111
