111111111111111111111
101000000000100000101
101111111110101010101
100000100010001010101
111110101011111010101
100010001010000010101
101011111010111110101
101010001010100010101
101110101010101010101
100000101010001010101
101111101011111010101
100010001000100010101
111110101110101110101
100000101010001000101
101111101011111011101
101000000000001010001
101111111111111010101
101000100000100010101
101010101110101111101
100010000010000000001
111111111111111111111
