111111111111111111111
100000001000000010001
111111101011101011101
100010001010101000001
101010111010101111101
101000100000100010101
101111111011111010101
100000001010000010001
111111101110111110111
100010001000100010101
101010111011101010101
101010000010101010101
101011111110101010101
101000001000101010001
101011101110101011101
101010000000101000001
111011111110101111111
100010001000101000001
101110101111101111101
100000100000000000001
111111111111111111111
