1111111111111111111111111111111111111111111111111
1010000000000000000000001010000010000000001000001
1011101111101111111111101010101010111111101010111
1000101000100010000010000010101000100010001010001
1110101010111010111011111110101111101010111111101
1010101010001000101000000000101010001000100000001
1010101011101011101111111111101010111111111011101
1010101010001000001000001000001010000000100010001
1010101011101011111011101011111011111110101110111
1010101000101010001000100010000000100010101000001
1010101110101110101010111111111110101010101111111
1000101000100010101010100000100000101010100000001
1011111011111010101110101010101110101010111111101
1000000010001000100000101010101000101010000000101
1111111111101111111111111010101111101011111110101
1000000010000010000010000010001000101000000010001
1011101010111110101110101111111010101110111011101
1010101000100000100000100010000010100010001000101
1010101110101111111111111010111110111011101110101
1000100010101000000000101000001000001010100010101
1110111010101110111110101111111011101010111010101
1000101010100000101000101000000010101010100010101
1011101011111111101011101011111110101010101111101
1010001000100000000010001000100010001010100000101
1010101110101111111111101110101110111010111110101
1000101010001000000000001010100000001000001010001
1111101011111010111111101010111111111111101011111
1010001000001010101000001010001000001000001000001
1010111110111010101011111011101011101011111110101
1010000010000010100010000010001000100010000010101
1011111011111110101110101110101110111110101010101
1000100000000000100010101000100010000010101010101
1010101111111111111010101011111011111010101011101
1010001000100010000000101000100010000010101000001
1011111010101011111111101110111110111111101111101
1000101010001000001000000010001000100000101000001
1110101011101111101111111111101011101110101111101
1010101000101000100000000000001010001000001000101
1010101110111010111111111110111010111011111010111
1000100010000010000010001000100010001010000010001
1011101011111111111011101011101110101110111111101
1010001000100010001000100000101010100000100000101
1010111110101010111110111011101010111111101110101
1010000010001010000010001010001000001000001010101
1011101011111010111011101110111111101011111010101
1000101010001010100010001000100010001010000010001
1110111010111011101010111011101011111010111111101
1000000010000000001010000000001000000010000000001
1111111111111111111111111111111111111111111111111
