111111111111111111111
100010000000001010001
111010101111101010101
101010100010101000101
101011111010101011101
101000001010001010001
101111101010111010111
100000100010001010001
101110111111101011101
101010000000101010001
101011111011101010101
100010100010001010101
111010101010111110101
101010101010000000101
101010101011111111101
101010101000100000001
101010101110101111111
101010101000100000001
101010101111111111101
100000100000000000001
111111111111111111111
