111111111111111111111
101000001000000000001
101110101010111111101
101000101010001000001
101011101110101111101
100010100010100000101
111110111011101110101
100000001000101010101
101111111110101010111
100010000000101010001
111010111111101011101
100010001000000010001
101111101111111110101
101000100010000010101
101010111010111010101
101010000010101000101
101011111110101111101
100010001000100000101
101110101011101110101
100000100010000010001
111111111111111111111
