111111111111111111111
100010000000100010001
111010111110101011101
101000100010101000001
101111101110101111101
100000100010101000101
101011101010101011101
101000001010001010001
101111111011111010111
100000001000001010101
111111101011101010101
101000101000100010001
101010101110111111101
100010001010001000101
101111111011101010101
101000001000100010001
101110101110111111111
101000100000001000001
101011111111101110101
100010000000000000101
111111111111111111111
