1111111111111111111111111111111111111111111111111
1010000000001000000000100000000000100000000000001
1011101111101111111010111110101111101010111111101
1000001000100000001010100010101000001010100000101
1111111110111111101010101010101011111011101110101
1000000010000000100010001010100000101000000010101
1111101010111010111111111011111110101111111010101
1000001010100010000000001010000010001000001010101
1011111011101111101111111010111011111011101010101
1010000000001000101000001010101000100010101010101
1010111111111010111011101010101110101110101110101
1010001010000010000010001000100010100010000000101
1011101010111111111110111111101010101011111111101
1000100010100000000010000010001000101010000010101
1110111010111110101111111010111111101010111010101
1000100010100010101000100010001000101000101010001
1011101110101011101010101111101110101111101011101
1000101000101010001010001000001000100010001000101
1110101011101010101011101011111011111010111110101
1000101010001000101010101010000010001010000010101
1011111010101110111010101011101110101011101010101
1010000010100010100010001000101000101010001010101
1010111110111011101110111110101011101010111010111
1010100010101010001000100010100010100000100010001
1010101110101010111111101010101110111111111111101
1000100000101010000000001010101000001000000010001
1011111011101011111111111010101011101011111010111
1000001000101000000000101000100010001000001010001
1111101110101111101110101111111111111011101011101
1000101000000010001000100000000010001010001010001
1110101011111110111011101111111010101010111010101
1000101010000000100010001010001010101010001000101
1010101110111111101110101010101010101111101111101
1010100010001000001000101000100000101000001000101
1010111010101011111011101111111111101011111010101
1010001010101010001000100000001000100010001010001
1011111011101010101110111111101010111111101011111
1000000010001000100010001000100010000000100000101
1011111110111111111011101110111111111110111110101
1000100000100000000010100000000000100010000010001
1110101111101111111110111111111110101011111011101
1000101010001000100010000000000000001000101000101
1011101010111010111010111111111111111110101110101
1010001000100010001000100010000010000000000010101
1010111011111011101111101010111011111111111110101
1010101010000010100000101010100010001000100000101
1010101011101110111110101010101110101010101111101
1000100000001000000000001000100000100010001000001
1111111111111111111111111111111111111111111111111
