1111111111111111111111111111111111111111111111111
1010000000000000000010000000001000000000100000001
1011101011111110111110101111101111101110111011101
1000101000001000100000100010000010001010000010001
1110101111101011101111111011111010111011111110111
1010100010001010001000001000100010100000000010101
1010111010101110111110101110111010111110101110101
1010100010101000100000100010001010000010101000101
1010101110101011101011111011101011101010101011101
1010101000101010001000100010001000101010101000001
1010101011111011111110111010111110101011101111101
1010101000000010000010001010100010101000100000001
1010111111111010111011101010111010111110101111111
1010001000001000101000001010001000000010101000001
1011101011101111101111111011101111111010111011101
1000100010101000000000001000100010100010100010001
1010111110101111111010111011111010101110101110101
1010001000100000001010000010001010001010001010101
1010101010111111101110111110101010111010111010111
1010100010000000100010100010100010100010000010001
1110111111111110111010101010111110101010111111101
1000100000001000100010101000100010101000100000001
1011101111101110101110101111101010111110101111111
1000001000100010101010101000001010000010100000001
1011111110111010101010101110111111111010111111101
1000100000001010101000100010100000100010001000101
1110101111101011101011111010101110101111101011101
1010101000001000001010000010000010100000100010001
1010101111101111111010111110111110111110111010101
1010100000101000000010100000001000000010101010101
1010101110101110111110111111111011101110101010111
1010100010100010101000100010000010001000100010001
1010111110111010101011101010111111101011101111101
1000100010101010001000101010000000101010000000101
1011101010101011111110101010111110111011111110101
1000101000100000000000101010000010000010001000101
1110101111111111111111101011111111101110101111101
1010100000000000001000101000001000100000101000001
1010111110111111101010101111101010111111101011101
1010100010001000100010101000100010100010101000101
1010101011101010111110101010111110101010101010101
1010001000101010100010001010000010001010001010101
1011111110101010101011111011111011111010111110111
1000001010100010001000001010001000001010000010001
1010101010111111111011111011101111101011111011101
1010100010100010001010001000100000001010000010001
1010111110101010101110101110101111111010111110101
1010000000001000100000100000100000000010000000101
1111111111111111111111111111111111111111111111111
