111111111111111111111
100010000000001000001
111010101111101111101
100010100000101000001
101110111110101011101
101000101000101010001
101011101011101011111
101000001000100010001
101110111110111110101
100010100010000000101
111011101010111111101
101000001010101000101
101111111010101010101
100000000010001010001
101111111111111011101
101000100000000010001
101010101111111110111
100010100010100010001
111110111010101011101
100000000010001000001
111111111111111111111
