111111111111111111111
101000100000001000001
101010101111101011101
101010001000101010001
101011111010101010111
100010000010101010001
111110111110101111101
101000001000101000001
101011101011101011111
100000101010001000001
101111101010111111101
100010001010100000001
101110111110101111101
101000100010100000101
111011101010101110101
100010001010101000101
101010111010111011101
101010001010001010101
101111101011101010101
100000001000000010001
111111111111111111111
