1111111111111111111111111111111111111111111111111
1000100000100000100000100000000010000010001000001
1110111010101010101111101111101011101010101010101
1010001010001010001000001000101000101000101010101
1011101011111011111011111011101110101111101110101
1010001010001000000010000010001000001000100010101
1010111010101111111010111010111111111011111010101
1010001010101000001000101010000000100000001010101
1011101010111011101111101011111110111011101010111
1000101000100010101000000010001010001010001010001
1011101110101110101110111110101011101010111010101
1010001000101000100010001000100000101010100010101
1010111111101010111011101011101111101010101111101
1000100010001010100010000010001000001010100010001
1011101010111011101111111110111011111110111010101
1000001010100010001000000010001010000000001000101
1111111010101010111011111011111010111011111111101
1000001000101010100010001000000010001000000010001
1110101111101010101110101111111111101111111010111
1000101010001000100010100000000000001000001000101
1011101010111111111010111111111111101110101111101
1010100010100000001010100000001000101000101000001
1010101110111110101010101111101010101011101010111
1010001000100000100010100010100010101000101010001
1011101011101111111110111010111110101110101111101
1000101000101000000010001000100000100000100000001
1010111110101011111011111110101111111111111111101
1010000000100010001000000000100000001000000000001
1011111111101111101111111111111111101011111111111
1000100010001000001000000000000000101010000010001
1110101010111110101011111111111110101011101010101
1010101000000000101000100000000010001000001010101
1010101111111111101110111110101011111111111010101
1010100010000010000010000010101000000000001010101
1010111110111010111111101010101111111111101011101
1000100000101010001000101010100000001000001000001
1011101111101011111010101010111111101110111111101
1010001000001010000010101010100000100010001000101
1010111011101010111110101010111010111011101010101
1000101000100010100010101010001010100010100010101
1111101110111110101010111011101010101110111110101
1000000010100010101010100010001010100010000000101
1011111010101010101010101110111010111011111011101
1010000010101010101000001000100010001000001010001
1010111110101010111111111011111111101111101010111
1010100000101010000010001010001000000010101010001
1010101111101011111010101010101011111010101111101
1010000000001000000010100000100010000000100000001
1111111111111111111111111111111111111111111111111
