1111111111111111111111111111111111111111111111111
1010000000100000000000000010000000100000000000001
1011101110101111111111111010111010111110111111111
1010001000101000000010001010101010000000100000001
1010111011101011111010111010101011111110101111101
1000101010000000001010100010101000001000101010001
1111101011111111111010101110101111101111101010101
1000001000000000001010001000100010001000101010101
1011101111111111101011111011111010111010101010111
1000100000001010001000001010000010000010000010001
1111111110101010111011101011101011111111111011101
1000000010101010101010100010001010001000001000101
1011111010101010101010111110111010101011101111101
1000001000100010100010000000101010101000100000001
1011101111111010111010111111101010101110111111101
1010001000000010001000100000001010100010000010001
1110111011111111101111101110101011111011111010111
1000100010000010001000000010101000000010001010001
1011111110111010111011111010111111111011101011111
1010000010100010001010001010000000001000101000001
1010111010101111101010101111111011111110101111101
1000100010100010001010100000001000001000101000001
1111101110111010111010111111101111101011101011101
1000001000101000100010000000100000001010001010101
1010111011101111101111111110101111101011101010101
1010100010000000100010001000101000101000101010001
1011101110111011111010101011111010111110101011101
1000101000101000000000101000000010000010001000101
1010101110101111111111111111101111101111101110101
1010100010001010000000000000100000100000101000101
1010111011101010101111111110111111101011101011101
1010001000100010101000000010000000101000001010001
1110101110111010111011111011111110111111111011111
1000101000101010001010001000000010001000001000001
1011111011101011101010111111111011101011101111101
1000001000101000100010000000100010001000100000101
1011101110101110111110101111101110111110111110101
1010100000100010001000101000001000100000100010001
1010111111101111101111101011111011101111101111101
1000100000100000001000001010001000100000100010001
1110111110101111111011101010101110101110101010111
1010000010000000100010101010100000101010101010101
1011111011111110101110101010111111101010101010101
1000000010001000001000001010000010000010101010101
1011111110101111111011111011111011111110111010101
1010000010101000001000001010001000100010001010001
1011101010101011101111111010111110101011101011101
1000001000100010000000000010000000001000001000001
1111111111111111111111111111111111111111111111111
