111111111111111111111
101010000010001000001
101010101010101011101
101010101000100010001
101010101111111110111
101000100010000010101
101111101011101010101
100000101000101010001
111110101110111011101
100000101000100000101
101111111011101111101
100000000010001000001
111111111110101011111
100010001000101000101
101010101011101110101
101000101010100000101
101111101010111111101
100010101010000000101
111010101011101110101
100000100000001000001
111111111111111111111
