111111111111111111111
101000100000100000001
101010101110101110111
100010001010100010001
111111111010111111101
100010000010000000001
101110111011111111101
100010101010001000101
101010101010101010101
101010001010100010001
101011101010111111111
101000101000100000001
101010101111111011101
101010100000000010001
101011111111111110111
101000001000001000101
101110111011101011101
101010001010100010001
101011101010111111101
100000100000000000001
111111111111111111111
