1111111111111111111111111111111111111111111111111
1000000000000000001000100000001000100000000010001
1111111111111111101011101110101010101111111010101
1000000000001000101000101010101010000010001000101
1111101111101010101010101010101111111110101110101
1000101000101010001010100010100000000000100010101
1010101010111011111110111010111111111111111011101
1010100010100010000000001010000000100000001010001
1010111110101111101111111011111110101110111010101
1010000000101000001000000000100000100010001000101
1011111110101011111011111111101111111011101111101
1000000010101000001010001000101000000000100000101
1011111010101111101010111010101111111111101110101
1010001010100000100000100010100000100000001000101
1011101011111110111111101110101110101111111011101
1000101000000010100000101010101000101010001010101
1110101110111110101110101010101011101010101010101
1010100010100000100010001010101000101000100000101
1010101010101111111011111010111110101011111111101
1010101010100010000010001000100000101000100000101
1010101110111011101110101011101111101111101110101
1000001000100010001000100010001000000000001000101
1111111010101110111110111111101011111111111010101
1000000010101000000010000000101010000010001010101
1011111110101110111011111110101010111010101011101
1010000000100010001000000010001010100010100010001
1011111111111011111111111011111010111110111010111
1000100000001000000010000010100010100010001010001
1010101111101111111010111110101110101011101011101
1010001000100010001000100010001000101000001010001
1011111110111010101111101010111010101111111110111
1010000000001000100000001000101010100000100010101
1011101111101111111111111111101010111110101010101
1000101010001000001000001000001010000010001000101
1110101010111010101110101011101011101111111111101
1000101000100010100010101010001010100000000010001
1011101111101110111010111010101010111111111010101
1010000000000010101010100010101010100000001000101
1011111110111110101010101110111010101011111011101
1010000010100010100010000010001010001010001010001
1010111011101010101111111110101011111010101110101
1010001010001010100000000010100000100010100000101
1011101010111010111111111011111110101010111111101
1010001000100010000010001000000010001010000000101
1010111111101111111010111111111011111011111110101
1000100000100000001010100000001000100010000010101
1111101011111111101010101011111110111110111010101
1000001000000000000010001000000000000000100000101
1111111111111111111111111111111111111111111111111
