1111111111111111111111111111111111111111111111111
1000001000000010000000000010000000000000100000001
1111101010111010111111111010111011111110111011101
1000101010100010000000100010101000100010000010001
1110101110101111111011101010101110101011111110111
1000100010100000101010001010001000101000100000101
1011111010111110101010101111101011101110101111101
1010000010001010100010101000001010100010001000101
1010111111101010111110111011111010111011111010101
1010000000101010100010001010100010001010000010001
1011111110101010101010101010101111101010111111101
1000000010001010001010100000101000101000100000001
1011111011111011111010111111101010101111101111111
1000101000100000000010100000001010000010101000001
1010101110101111111111101111111011111010101110101
1010100000100000100000001000100000100000100010101
1110111111111110101111111010101110101111111011101
1000100000001000101000100010001000101000000010001
1010101111101011101010111110111011111011111110101
1010100010001010001010000010001000001010000000101
1011101110101010111011111011101111101010111111111
1000101000101010100010001010001000101010000000001
1010101011111010101110101010111010101011111111101
1010001000000010001000100010100010101000000000101
1011111111111111111011111111101110101111111110101
1010001000001000000010100000001010100000000010001
1010101011101011111110101011111010111110111011101
1000100010101010000000101000100010000000100010001
1111111110101011111110101110101011111111101110111
1000100000001010000010000010101010100000100010101
1110101111111010111011111110101010101011111010101
1000101000000010100000000000101000101000000010101
1011101011111110111111111111101111101111111110101
1000001000100000000010100000100010001000001010001
1011111110111111111010101110101010111110101011101
1010000000100000001010001010001010100000101010001
1011111011101111101010111011111010101111101010111
1010001000000000101010100000101010101000001010001
1010101111101111101010111010101010101011111011101
1000101000101000001010000010001000001000001010001
1111101010111011111011111111111111111111101010111
1000100010001000100000000000000000000010000010001
1010111111101110101111111111111111111011111111101
1010000000100000101000000000100010001000000000101
1011111110111111101111101110111010101111111110101
1010001010000010001000001010001000100000001010001
1010101010111110111011111011101111101111101011111
1000100010000000000010000000000000001000000000001
1111111111111111111111111111111111111111111111111
