111111111111111111111
100010001000000000001
111010101111101111101
100010100000101000001
101110111110101011111
101000001000101000001
101111101011111110101
100000101000000010101
111110101111111011101
100000100010001000001
101111101010111111101
100010001010000000101
111010111011111110101
101010001000000010001
101011101111111011101
100010000000001000101
101111101111111110101
100000101000001000101
111110111011101011101
100000000010000010001
111111111111111111111
