111111111111111111111
100000100000000000101
111110101111111110101
100010001000000010101
111011111011101010101
100000001010001010001
101110111010111011101
100010100010001000101
101011101111101111101
101000001000100000001
101111111110111111111
101000000010000010001
101111101010111010101
100000101010001010101
111110101011101011101
100010101000001010001
101010101111111010101
101010001000001000101
101011111010111111101
101000000010000000001
111111111111111111111
