1111111111111111111111111111111111111111111111111
1010001000001000100000000010100000000000000000001
1010101110101110101110111010101111111011101111111
1000101000100010100010001010001010001000100000001
1111101011111010101111101011101010101111111111101
1000101010100010001000101000100010100000001000001
1011101010101111101010101110111110111111101011101
1010001010000000101010001010000000100000101000101
1010111011111110111011111011111111101111101010111
1010101000000010100010000000001000001000001010001
1010101011111010101110111011101011101011111111101
1000100010000010001000100010000010001010000000001
1011111110111111111011101111111110111010111111101
1000001000101000000010100000100010100010100010001
1111101011101011111010111110101010101110101011101
1010001010000010001000001010101000101000001000101
1010111011111110101111101010111011101111111010111
1010001000000000101000001010001000100000001010001
1011101111111111101011111011101110111111101111101
1010001000000000101000000010100010100000101000001
1010111011111110101111111010111011101010101011101
1010000010000000100000101000101000001010100010001
1011111110111111111010101110101111111011111110111
1000000010000000001010100010100000001000100010101
1011101011111111101110111010111011101110101010101
1000101000000000100000100010001010000010001000101
1110101111111110111111101011101110111111111111101
1000101000000010001000001010100010000000000000001
1011101011111011101011111010111011111110101111101
1000101010100010000010001010100010000010100000101
1110101010101111111110101010101110111011111110111
1000100010100000100000101010101000101000000010001
1011111110111110101011101010101011101111111011101
1000000000000010101010001010101010000000001000001
1011111111111110101011111010101011111011101111101
1010001000000000101000000010100010001000100000101
1010101011111111101111111110111110101111111011101
1010101010000000100000100000001000100000000010001
1010101011101111111110111110101011111111111110111
1010100010001000000000001000100010001000000010101
1110111110111011111111101011111010101011111010101
1000100000000010100000100010000010101000100010101
1011111011111010101110101111111110101110101010101
1010001010001000100010101000100010100010101010101
1010101010101111111010111010101010111010101110101
1010101010101000100010000010001010001000100010001
1010101110101010101111111111111011101111111011101
1000100000100010000000000000001000000000001000001
1111111111111111111111111111111111111111111111111
