1111111111111111111111111111111111111111111111111
1000100000100010000000001000000010000010000000001
1110101110111010101111101011111010101110111110101
1010001010001000101000100010001010100000100010101
1011111011101111101110111111101010111111101011101
1000000000101000100010000000001010100000101000001
1111101110101010111010111011111010101110101111101
1000101000101010000010101000000010100010101000001
1010111010101011111110101111111111111010101011111
1010001010100010000010000010000000000010101000001
1011101010111110101111111010111110111110101111101
1010001010100000100000001010001000100010001000001
1011101010111110111111101010111011111011111011111
1000100010000010000010001010100010000000001010001
1010111111111011101110101011101110101111111010101
1010001000100010001000101000001000101000000010101
1011101010101111111011101111111010101011111111101
1010100010101000000010001000000010101010000000001
1010111110101011111111101111111110101010111111101
1010000010100010000000100010000000101000100010101
1010111110111110111110111010111111111111101010101
1000100010100000100010100000100010000000001000101
1110101010101111101010101111101010101111111011101
1000101000100010001010100010001010100010001010001
1011101111111011111010111110111010111010101110111
1000100000001010001010000000101000101000101000101
1110111110101010101011111111101111101111101011101
1010100010101000100000100000000010000000101000001
1010101110101111111110101111111011101110101111101
1000100010100000000010101000001010001000100000101
1011101010111110111110101110111010111011111011101
1010001010000010100010100010001000101000001000001
1010111011111011101010101011101111101111101111111
1010001000001000001010101000100010000000001000001
1011101110111111111010101110101010111111111011101
1010000010100000000010101000101010000010000010001
1010111110101111111110111011101011111011111010111
1010001000100000000010000010001000001000001010001
1011101011111111111011111110101011111111101011101
1000101000001000001000000000101010000000101010001
1110101110101010101111111111101110111110101110111
1000101000101010100000000010101000100010100010001
1011111011101110111111111010101011111010111011101
1000001000100010100000100010101000000010001000101
1111101110111010101110101110101111111010111110101
1000100010100010100010101000101000100010000010101
1010111010101110101011101110101010101111101110101
1010000000100000101000000000100010000000100000001
1111111111111111111111111111111111111111111111111
