111111111111111111111
100010000000100000001
111010101111101110101
101010100000001010101
101010111111111010101
100010100000000010101
101110111010111110101
101010001010100010101
101011101011101010111
101000000010001010001
101110111110111010101
100010001000100010101
111010111011101111101
101010100010101000001
101011101110101110101
101000101000100000101
101110101010111111101
100010101010001000101
101010101010111010101
101000001010000010001
111111111111111111111
