111111111111111111111
100000100000000000101
111110101110111110101
100010101000100010001
101110101011101011101
100010101000101010001
111010101111101011111
100010100000001000001
101110111110111111101
100010000010100000001
101011111010101111111
101000100010100000001
111110101110111111101
100000101000100000101
101110101111101110101
100010100000101010001
111011111110101011101
100010000000101010001
101110111111101010111
100000000000001000001
111111111111111111111
