1111111111111111111111111111111111111111111111111
1010000000100000000000000000000000000010001000001
1010101110111111111111101111111110111110101011101
1010100010000000000000101000000010100000100010001
1011111011111111111110101011111010101111111110111
1010000010000000100010100010001010001000000010001
1010111110111111101010111111101011111110111111101
1000101000100000101010100000101000000010001000001
1111101010101110101010101010101111111011101011101
1010001010101010001000101010001000001000101000101
1010101010101011111111111011111011101110101110111
1010100010101000000000001000001010000010001010001
1010111110101011111110101111101010111111101011101
1000100010001000101000100000100010000000100000101
1011111011111110101011111110111111101011111011101
1000000000000010001010000010000000101000001010001
1111111111111011101010111011111110111111101010111
1000000010000010101010100000100000100000100010001
1011101010111110101010111111101111101110111110101
1010001010100000101010000000001000100010000010101
1010111010111010101010111111111010101011111010101
1010100010001010101010000000100010101010001010101
1110101111101011101011111110111010111011101010101
1000100010001000001000100010001010001000101010101
1011111110111011111110101011101011101010101011101
1010000010100000100000101000100010001010100010001
1010111010101111101111101011111110111010101110101
1010001000100010001000001010001000100010100000101
1011101111111110111111101110101011101110111111101
1000100000100000100000101000101010000010000010001
1010111110101111101010101011101011111110111011111
1010000000100010001010101000100010000010001010001
1011111111111010111010101110111110111011101010101
1000000010000010100010000010001000100000101000101
1111111010111110101111111011101010111110111110101
1010001000101000100010001010101010100010000010101
1010101111101011111011101010101010101011111010101
1010100000001000101000100010101010001010000010101
1010111110111110101110101110101011111011111010101
1000100010000010100010100000101000101010001010101
1011101011111010101110111111101110101010101011101
1000001000101000101000100000001000101010101000001
1111111110101111101010101111111011101010101111101
1000100010100000001010101000001010001000100000101
1110101010111110101011101011101011101111111110101
1000101010100000101000001000100000000010000010101
1011101010101111101111111111111111111110111010101
1000001000001000000000000000000000000000100000101
1111111111111111111111111111111111111111111111111
