111111111111111111111
101000000000000000001
101110111111111111101
100010000010000000101
111011111010111111101
101000001010000010001
101111101011111010111
100000100010000010101
101110111110111010101
100010000000100010101
111010111110111110101
100010001000100000101
101111101011101111101
101000101000101000001
101010101111101011111
101010101000001000001
101010101011111011101
101010100010001010001
101110111110101110101
100000000000100000101
111111111111111111111
