1111111111111111111111111111111111111111111111111
1000100000100010000000100000100010000010000000001
1110111011101010101110101110101010111010111011101
1010001000001010101010001000101000101010100010001
1011101011111010101011111011101111101010101111111
1000001010100010101000001010100000001000100000001
1011111010101110101010111010111111101111101111101
1010001000100010101010000000100000001000100000101
1010101111111010101111111110101111101010111111101
1010100000001000100010001000101000101010100010001
1010111111101111111010101111101010111010101010101
1010000010000000001010100000001010001010001000101
1011111011111111101010111111111011101011111111101
1000001000100000101000000000100010000010000010001
1111101110111110101110111111101111111111111010111
1000100010100000100010100000100000100000000010101
1110111010101111111010101110111110111011111010101
1000100010101000000010101000000000100010001010001
1010101110101011111111101111111111101110101111101
1010100000101010000000100010000000100000100010001
1010111111101010111110101011111011101111111010111
1010000010001000101000101000100010001000100010101
1011111011101111101011111110101010111010101010101
1010001000001010000010001000101010101010001010001
1010111111101010111110101011101010101011111011101
1010000000000010000000100010001010001010001000101
1010111111111111111111111111101011101010101110101
1010100010100000001000000000001010001000101000101
1010101010101110111010111111111110111111101111101
1010001000101010001010100000000010001000100000001
1011111011101011101010101111111011101010111111111
1000001010001010001010001000001000101010100000001
1011101010111010111011111110101110101010101111101
1000101010100010000010000010100010101010100010001
1110101110101111111111101010101110101010111010101
1000100010101000000000001000101000101010001010101
1011111010101011101111111111101011101011101110101
1000100010101010001000001000001000001000100000101
1011101110101010111111101011111111111010111111101
1010001000100010001000100010000000000010101000001
1010111011111111101010101111101111111110101011111
1010001010000000101010100000100010001000100010001
1011101010111110101010111110111010101011111110101
1010100010101000100010100010001000101000000000101
1010111110101011111110101111101111111011111111101
1010000010101010000010100000101000001000000010001
1010111010101010111010101110101011101111111110101
1000100000100000100000100010000010000000000000101
1111111111111111111111111111111111111111111111111
