1111111111111111111111111111111111111111111111111
1010000010000010000000000000100000000010000000001
1010111010101110111111101110111010111011111011101
1010100010100000100000001010001010100010000010001
1011101010111111101111111011101110101110111110111
1000101010001000001000000000100000101010001000101
1110101011101010111111111110111111101010101011101
1000101010001010100010001000101000101000101010001
1011101110111010101010101010101010101111101010101
1010000000001010101010101010101010001000001000101
1011111111111011101010101010101011111011101111111
1000000000001000001010100010001000100000101000001
1111111111101111111010111110111110101110111011101
1000001000100000000010001010100000100010001010101
1010111010111111111111101010101111111110101010101
1010000010000000000000001010101000000010101000101
1011111111101111111111111010101010111011101110101
1000001000001010000000100000101010100010001000101
1110111011111010101110101111101010101110111011101
1000100010001000101000100010101010101000100000101
1111101110101011101111111010101110101010101111101
1000001000101000100010001010100010101010001010001
1011111011101011111010101010111010101011111010101
1000001010101010000010101000101000101000000010101
1111101010101010111010101110101111101111111110101
1000100000101010001010100010000000100000000000101
1010111011101011101110111011111011111111111111101
1010001010001010100000100000001010000000000000101
1011101010111010111111101111111010111110111110101
1010001010001010000000100010001010001000101000101
1011101011101010111010111010101010111011101011101
1000101000101010100010001000100010100010000010001
1010101111101011101111101111111110101111111110111
1010100000001010001000000000100010100000000000101
1010111011111010111111111111101010111111111111101
1010100010001000100000000000001000100000001000001
1110111110101111101111111111111111101111101110101
1000100010100000100000101000000010000010101000101
1011101010111110111110101010111010111010101011101
1010001010001000000010101010001010101010000010001
1010111011101011101110101011101110101011111111101
1010101000001010001000100000100010001000100000101
1010101111111011111011111110111010111110101110101
1010000010001000001000000010001000100010000010101
1011111010111111101111111011111011101010111110101
1000100010000010000000001000001000101010100010101
1011101111111010111111111111101111101011101010101
1000000000000010000000000000000000001000001000101
1111111111111111111111111111111111111111111111111
