111111111111111111111
100000100010000000001
111110101010111011111
100000101010001000001
101111101111101111101
101000000000101000001
101111111011101011111
100010001000001000001
111010101111111110101
101000100010000010101
101111111010111010101
100000001000100010101
101110101111101111101
101000100010001000001
111010111110111110101
100010100010000010101
101011101011111010101
101010001000001000101
101110111011111111101
100000001000000000001
111111111111111111111
