1111111111111111111111111111111111111111111111111
1010100000001000000000000000000000100000001000001
1010101110111011111111101111101111101011111010101
1010001010001010001000100000101000001000100010101
1011101011101010101010101110111011111110101110101
1000101000101010101010100010001000001010001000101
1110101110101010101010111011101111101011111011101
1000101000101010101010101000101000000010000010101
1011101010101010111010101110101011111110111110101
1000100010100000100010100010101010100010001000001
1110111111101111101110101010101010101011101111111
1010001000100010001010101000101000101000001000001
1011101010111010111010111111101110101011111011101
1000101010001010100000100000100000101010000000101
1010101011101110101111101110111110101110111110101
1010100010001000101000001000000010100000100010101
1010111110111011101011111111111011111111101010101
1010100010100000100010000000001000100000101010101
1010101110101110111110111110101110101110101010101
1010001000101010000010100010100010001000001010101
1011111011101011111010101010111011111111111011101
1010001010000000001000101010001000000000100000101
1010101011111111101111101011111110111110111110101
1000101000000000101000101000000010001010000010101
1111101111111110111010101111111011101011111010101
1000000010000010001010001010000010101000001010001
1011111010101011101011111010111110101110111011101
1010000010101000100010001000100000100000100010001
1011111110101111111110101011111010111110101110111
1000100000101000000010100010000010001000101000001
1010101111101011101010111111101011111011101111101
1010101000101010001010000000101010000000100000101
1110101011101010111011111110101110111111111010101
1000101000101010101010000010100000100000001010101
1011101110101010101010111010111111101111101010101
1000001000100010101010100010100000101010001010101
1011111011111110101010111010101110101010111010111
1010000010000010101010001010001010001010100010001
1010101010111010101011101011111011111010101111101
1010101010001000101010001010000010000010100000101
1010101111101111101010111010111010111010111011101
1010100000101000000000100010001000100010100010001
1011101011101011111111111011101111101010101110111
1000101010001000100000001000100010001010100010001
1110111010111110101111101111111010111010111011101
1000100010001000101000101000000010100010001000101
1011101011101111101010101011111110111111101111101
1000001000100000000010100000000010000000000000001
1111111111111111111111111111111111111111111111111
