1111111111111111111111111111111111111111111111111
1010000000100010000010000000000000000000001000001
1011111010101110101011111111111111111110101110101
1000001010001000101000000000000000100000100010101
1111101011101011101111111111111110101111111011101
1000101000101010101000000000001000100000001000101
1110101110111010101111111010111011111111101110101
1000100010000010100010000010100010001000001000101
1010111011101110111010111111101110101011111011101
1010001000101000100010000000001000101000100000001
1011111110101011101110111110111110101010111111101
1010000000101000100010100010100000101010000010101
1010111111101110111011101010111011101111111010101
1000100010000010001000101010000010000000001010101
1011101011111010111110101011111111111111101010101
1000001000100010000010001000000000001000100010101
1111111110101111111011111111111111101110111110101
1000100010100000100000000000000000100010000000101
1010101010111110101111111111111011111010111110101
1010101000100010001000000010001010000010000010101
1010101111101011111011111010101110111111101110101
1010101000001010001010001000100010001010001000101
1011101011111010101010101111111011101010111011101
1010001010001000100010100000001000001010001000101
1010111010101011111110111110111111111011101110101
1010100000101010000010100010000000001000001010001
1010111111101110111010101011111110111011111011111
1010100000100000001010101000000010001010000010001
1010101110101111111010111110111111101010111011101
1010001010101000100010100000100000100010001000001
1011111010101011101110101111101110111111101111111
1000001000100010001000100000001000000010001000001
1011101011111110111011111110111011111010111011101
1010001000000000101000000010001010000000100010001
1011111111111111101111111011101010111111101110101
1000100000000000001000000010101010001000100010101
1010101110111110111011111110101011111010111010111
1010000010100010100010000000001000100010000010001
1011111110101010101111111110111110101111111111101
1010001000101000100000000010100010001000000000101
1010101011101111111111111010101011111011111110101
1000101010000000100000000010001000001000001000101
1111101010111111101111111111111111101111111010101
1010001010101000101000000000100000000000000010101
1010111010101010101011111110111111111111111111101
1010101010001010101000101000100010000000001000001
1010101011111010101110101011101010111111101011101
1000001000000010000000100000001000100000000010001
1111111111111111111111111111111111111111111111111
