111111111111111111111
100000001000001000001
111111101011101010101
100000101010001010101
101110101010111110101
101000100010000000101
111011111111111111101
100010000000000000101
101010111111111110101
101010001000100010001
101111101010101011111
100010001010001000001
101010111011111011101
101000100010001010001
101111101110101110101
101000001000100010101
101111111011111010111
101000000010001010001
101011111110111011101
100010000000000000001
111111111111111111111
