1111111111111111111111111111111111111111111111111
1000101000000000000010001000000010000000001000001
1110101011111011111110101011111010111011111010111
1010100010000010000000100010000010101000000010001
1010111110111110111111111110111010101111111111101
1010001000100000100000100010101010100000101000001
1011101010101111101110111010101010111010101011101
1000101010101000001000000010100010001010101000101
1011101010101111101111111010111111101010101110101
1000001010100000100010000010000000100010001010101
1011111011111110111011111111111110111111101010111
1010000010000010001000000000000010000010101010001
1011101010111011101011111110101111101010101011101
1000101010100000101000100010101000001000101000101
1110101110101110101111101011101011111111101110101
1010101000100010100010001000101000000000100010101
1010101011111011111010111110101111111110111010101
1010101000101000001000100010000010000010100000101
1010101110101110101111101011111010101110101111101
1010100010101000101000001000100010100010001010001
1010101010101011111011111010101110111011111010101
1000101000101000000010000010101010101000000010101
1011101111101111111110111111101010101110101110101
1010001000000000000010100010001000001010101000101
1011101010111111111010101010111111101010101011101
1000101010001000100010001010100000101010101000101
1110101011101010111110111010101110101010111110101
1010101000101010000010001000001010100010001000101
1010101111101011111011111111111010111111101011111
1000101000001010001000001000100000000000001010001
1011101011111011101111101010111111111111101010101
1000101010000010000010100010001000100000101000101
1110101010111110111010111111101010111110101111101
1000100010101000001010000000100010100010101000101
1011111010101011101010111110111110101010101011101
1010000010101010001010000010000010001010101000101
1011111110101010111011111011111111111010101110101
1000000010101010100000001010000000001010000000101
1111111010101010111111101010111111101011111110101
1000001010100010100010000010100000101000100000101
1010111010111110101011111110111010101110101111101
1010000010100010101010000010100010101000100010001
1011111110101010101010111010101011101011111010111
1000100010001010001010100010101010001000100010001
1110101011111010111010101010101110111110101111101
1000101000001010001000101010101000100010100010001
1011101111101011101111101110101011101010111110101
1000001000000010000000100000001000001000000000101
1111111111111111111111111111111111111111111111111
