1111111111111111111111111111111111111111111111111
1000001000000000000000100000000000001000000000101
1111101011111111111010101111111110101011111010101
1000101000001000100010100010000000101010001010001
1010101011111010101110111110111111111011101011111
1010101010001010001010000010000000001000001010001
1011101110101011111011111011101111101111101010101
1000100000100010000000001000101000100000101000101
1110111111111111111011111110101010111110101111101
1000100010000000000010001000100010001000101010001
1010101010111011111110101011111111101011101010101
1010001000100010000010101010000010001000001010101
1011111111101110111010101010111110111111111010111
1000100010000010101000100010001000100000000010001
1010111010111110101111111110101011101111111011101
1010001000100000100000100010100010100000100000101
1111101110101111101110101010111110101110111110101
1000100010101000000010001010000010000010001000101
1010111010101111111011111011111011101111101011101
1010000010100000001010001010001000101000001000101
1011111111111111101011101011101110111011111110101
1000000000000000100010001000100000100010001000101
1011111111101011111110101110111011101110111011101
1010000000101010000000101010001010001010000000101
1011111010101110111110101011101011101010111111101
1000100010100010001010100000101000001010001000101
1110101110111011101010111110101111111011101010101
1010101000101000000010000010100000100000001010101
1010101110101111111111111010111110101111111010101
1010100010001010000000000010000010100010000010001
1010101011101010111110111111111110111110111111101
1000101010001010100000100010000010000010001000001
1011111010111010111110101010111011111010101110111
1010000010100010000010101000101000100010100010101
1010101110111011111011101111101110101111111010101
1010101010000010001010001000000010001000001010001
1011101011111010101010111011101111111011101011101
1000001000000010101010001000100000000000100010001
1111111011111111101011101110111111101110111110111
1000001000100000101000001000001000101000100010101
1011101110111010101111111011111010101011101010101
1000100010100010000000001000100010101010001010001
1110111010101110111111111011101110111010111011101
1000101000101000100000000010001010001010100000101
1011101111101111101111101110111011101010111111101
1010000010000000001000101000100000101010100000101
1011101011111111111010111011101111101010101110101
1000001000000000000010000010000000000010000010001
1111111111111111111111111111111111111111111111111
