1111111111111111111111111111111111111111111111111
1000100000000010000000001000000000001000100000001
1110101011111010101111111010111110111010101111101
1000101000001010101000000010100000100010001010001
1011101111101010101011111110111111101111111010101
1010001000101010100000000010001000001000000010101
1010111010101110111111111111101011111011101110101
1010100010100010101000000000101000101010001000101
1010111011111010101011111110101110101010111011101
1010000010000010101010000010000010100010100010101
1011111110111110101011101111101110111110101110101
1000001000100000001000100000101000000000101000001
1111101011101111111110101110101011111110101011111
1000101000001000100000100010001010000010101000101
1011101111101110101111111111111010111011101110101
1000100000101000100000100000000010100010001000001
1010111110101010111110101111111110101110111111101
1010001000100010100010000000000010100010000010001
1011101011111110101011111111111110111011111011111
1010001000100010001000100000000010001000001000001
1010111110101011111110101111111011101111101111101
1010000010001010001000101000001000100010000000101
1011101111111010111011101111101110111011111110101
1000101000001010001010101000000010001000001000101
1110101010111010101010101010111111101011101011101
1000100010000010100000101010100000001010001000001
1011111111111111111111101010101111111010111111101
1000000010001000000000001010100010000010000000101
1111111010101011111111111010111011111011111110101
1010001000100010000010000010101010001000001000101
1010101111111110111010111110101010101111101011101
1010100000000000100010000010001010100010001000101
1010111011111111101111111011101010111011101110101
1000101000001000101000001000101010100000101010101
1011101111101010101011101110101010111110101010101
1010000000101010000010000000101010000010100010101
1010111011101111111111111111111011111010111110111
1010001010001000000000001000001000000010000010001
1010111010111011111111101011101111111111111011101
1010100010100010000000101000101000001000001000001
1011101010101110111010101110101011101010111111101
1000001010101000100010100010100010001010000000101
1111111010101011101110111010111110111011111011101
1000001010001000101000101010000010001000001000001
1011101011111110101011101011111011101111101111111
1000101000001000101010001000001010100000101000001
1010111111101111101010101111101010111110101011101
1010000000000000001000100000100000000010000010001
1111111111111111111111111111111111111111111111111
