1111111111111111111111111111111111111111111111111
1000100000000000000000001000000000001000000000001
1110111111101011111111101110111011111011111111101
1010000000101000000010100010001010000010000000101
1011111110111111111010111011101110111110111110101
1000100010001000000010001000100000001010100010001
1010111011101011111110101110101111101010101111101
1010000000100010100000100010101000100010100000001
1011101111111110101011111010111010111010111111111
1000101000100010001000001010000010101010001000001
1010111010101010111111101111111110101011101011101
1010000010001000100010001000000010100000100000101
1011111111111111101010101011111010111111111111101
1010001000001000101000101010100010100000000000001
1010101110101110101111101010101110101111111111101
1000101000100010101000001010100000101000100000101
1111101011111010101011111010111111101011101110101
1010001010001000101010000010000000001010001000101
1010111011101011101110111111101011111010111010101
1010100010001010001000100000101000101000100010101
1010101110111010111011101010111110101011101111101
1000101000100010001000101010000010100000100010001
1011101010101111101110111011111010111110111010111
1010001010001000100010001000100000100010001000101
1011101011111010101011101110111110101011101111101
1000001010000010101000101000100010101010100000001
1111111010111110101111101011101011101010111111101
1000001000100010100000001000001000001010000000101
1010111111101110111111111011111111111010101110101
1010100000001000100000001000100000100010101010101
1011101111101011111110111110101110101110101010101
1010001000101010000000100010001000101010101000101
1010111011101010111111101011111011101010101011101
1010001000100010100000001000001010101000101010001
1011101010111110101111111110101010101110101110111
1010001010000010001000100000101010100010100010001
1010111010111010111110101111101010111011101011101
1000100010100010100000101000101010001000101000101
1011111110101110101011101010111010101110111011101
1000000000101000101010001010000000100010001000001
1111111111101011101110101011111111111111101110111
1010000010001000001000101000000010001000100010101
1010101110111111101011111110111110101010111010101
1010100010001000001000000000100000100010000010001
1010111011101011111111101111101111111111111111101
1010100010001000100000100010001000001000100000001
1010101110111111101110111110111010111010101111111
1000100000000000001000000000100010000010000000001
1111111111111111111111111111111111111111111111111
