111111111111111111111
100000100000100000001
111110101110111111101
100000100010000000001
101111111011111111101
101000000010000010001
101010111111111010111
101010001000001010001
101011101011101011101
101010001010000000101
101010111010111111101
101010100010100000001
101110101110101111111
101000100010100000101
101011101011111110101
100010001000001000101
111110111111101011101
100010100000101000101
101010101110101110101
101000001000100000001
111111111111111111111
