1111111111111111111111111111111111111111111111111
1010000010000000000010000000000000001000000000101
1011111010111110111010111111111110111011101110101
1000001000000010100010101000000010001000100010001
1111101111111010111110101011111010101110111011111
1000001000001010000000001010100010100000001000001
1011111011101011111111111010101110111111111110101
1000000010001000000010000010100010000010000010101
1111111110111111111110111110111010111110111010101
1000000010100010001000100000001010100010100010101
1011101110101010101011101111101011101010101111101
1010001000101000100010001010001000001000100000101
1011111011101111111110111010111111111111111110101
1000001000100010001000001010001000001000000010001
1111101110111010101110101011101111101011111011101
1000000010001000100010101000100000001010001000101
1011111011101111111011101011111111101010101011101
1000101010101000000010001000001000001010101000001
1110101010101011111110101111101011111011101111111
1000100010100010000000101000100010001000000010001
1011111010111110111110111010111110101111111010111
1000001000100000100010100010000000101000001010001
1111101110101011101110101111111111101011101011101
1000101000101000100000100010001000100010001000101
1010101011101110111110111010111010111110111110101
1010001010001010000010100010000010000010000000101
1011111110111011111011101111111111111011111111101
1000000000100010001010001000000000001000000000001
1011111111101010101010111011111111101111111111101
1000000000101010101010100010000000100000001000001
1111111110111010101010111010111110111111101011101
1000100010100010101010001010100000000010101010001
1011101010101110101011101010101111111010101011111
1000001000100010100000100010100000101000101000001
1011111111101010111111111111111110101110101111101
1010000000101010000000000010000000101000100010001
1010111011101011111110111010111111101011111010111
1010100010001000000010001000100000100010000010001
1010101110111011101111101011101110111110111111101
1010100000100010001000101010001010000010000000001
1010111111101110111010101110111011111011111111101
1010100000100010001010100010000010001000100010101
1010101011111011111010111011111010111010101010101
1010001010001000001010000000100010100010001000101
1010111110101110101011111111101110101111111110101
1010100000100010101010000010001000101000100000101
1011101111111011101010111010111110101010111111101
1000001000000000001000001000000000100010000000001
1111111111111111111111111111111111111111111111111
