111111111111111111111
100010000010000000001
111010101110111110111
101010100000100010001
101011101111101011101
101000100010001000101
101110111010111110101
101000100010100010001
101011101110101011101
101010001000101010001
101011111011101010111
101000000010101000101
101111111110101111101
100000100000001000001
101110101111111110111
101000100010000010001
101111111010111011101
100000001010101010001
101110111010101010101
100010000000100000101
111111111111111111111
