1111111111111111111111111111111111111111111111111
1010000010000000100000001000000010000000000000001
1011101011101110111011101011111011111111111011101
1010001000001010000010001010000000001000000010101
1010111111111011111110111011111111101011111110101
1000100010000010000010100000000000100010100000101
1111101010101110101110111111111110111110101011101
1010001010101000100000100000100000100010001010001
1010101010101011111111101110101111111010111010111
1000101000101010001000001010001000000010101010101
1011101011111010101011101011111011101110101010101
1010001010001010101000101000001000100010001000101
1010101110101010101110101011111110111011101111101
1010101000101010100000101000000000100010100010001
1010101011101011111111101011111111101010111011101
1010101010100010000010001000001010001000100010001
1110111010111110111010111111101010111011101110111
1000100010000000101010100010000010100010001000001
1010101110111111101010101010111110101110111011101
1010101000001000101000101010100000101000101000101
1011101011101010101111101011101111111011101110101
1000101010100010100010001000001000000010001000101
1010101010111110101010101111111011111111101011101
1010001010001000101000101000000010000000100000101
1011111011101011101111101011111111101110111111101
1000001000101000101000101010001000101010100000101
1111101110101110101010101010101010101010101110101
1010001000100010100010101010101010001010001010101
1010111011101110101110101010101011111011111010101
1010101000001000101000101010101010000000000010101
1010101111101011101011111010101010111111101010101
1010101000001010001000100010100010000010001010101
1010101011111011111110101110111111101110111010101
1010100010000010000000100000101000001000101010001
1010101110111110111110111111101011111011101011101
1000100010001010001010001000100010001010100010101
1011111011101010101011101011101110101010101110101
1000001010001000101000001000000000101010001000101
1111101110111011101011111110111111111010111110101
1000001000100000101000000010100000000010000000101
1011111011111111101111111011101111111111111110101
1010100010000000001000001000001000000000000010101
1010101011101111101011101111111011111110101110101
1010001010001000101010100000001000100010101000101
1011111010111010101010111111101110101011101011101
1000000010001010001010001010001000101000100000101
1111111110101111111010101010111111101110111111101
1000000000100000000000100010000000000010000000001
1111111111111111111111111111111111111111111111111
