1111111111111111111111111111111111111111111111111
1000100010000000001000001000000010000000000010001
1110101010111110101110101011111010111110111011101
1000101000001000100010101000100010100010101000001
1011101111111011111010101110101110101110101111101
1010101000000010001010100000100000101000100000101
1010101011111110101011101111111011101011101011101
1010101010100000101000100010001000101010001000001
1010101010101110101110111110101110101011111110111
1010101010001000101000100000101010101010000010001
1010101010111011111011101111101010101010111011101
1010001010101000001010001000001010001000001010001
1010111010101111101010111011111011101111111010111
1010001010000010001000100010000010001010000010101
1010111011111010111111101110111010111010111110101
1010100010001010000010101000101010001010100000001
1011101111101011101010101011101011101010111111101
1010001000001010001000101000001000101010001000101
1010111010111010111110101111101110101011101010101
1000100010100010000010101000100010001000100010101
1111101011101111111010101011111011111011111110111
1000101000001000001010101000100010100010000010001
1011101111111011111011101010101110101010101111101
1010001000100010000010001010001010001000100000101
1010111010101010111010111110111010111111111110101
1000100010101010101010000010100010001000100000101
1011101110101010101011111010101011101010101111101
1000001010001010100000001010101010001010001000001
1111111011111010111111111010101110111011111011101
1000001000100010100010000010100010100010000010101
1010111010101110101010111110101010101110111110101
1010100010100010001010000010101000101000100010001
1010101110111011111011111010111111101011101010111
1010100010100010001010001010000000001010001010001
1110111010101110111010101010111111111010111011101
1000100010001000100010100010100010000010100000101
1011101111111011101110111111101010111110111111101
1010001000001000100000100000001000100010001000001
1010111011101010111111111110111111101011101011111
1010001000100010001000000000100000001010001000101
1011101011111110101110111111111011111010111110101
1000101010000000100000100000000010001000100000101
1110101010111111111111101011101110101111101111101
1000101010100000001000001000101000100000100000001
1011101010101110111011111110111011111110111111101
1010001010101000100010001010100010000010000010001
1010111110101011101110101010101110111011101110111
1000000000101000000000100010000000100000100000001
1111111111111111111111111111111111111111111111111
