1111111111111111111111111111111111111111111111111
1010000000100000000010000000001000000000000000001
1010111110101111111110111110111011111111101111101
1000100010101000000010100010001000100000001000001
1111111010101011111010111011101011101111111011111
1000001010100000100010000010100010001000001000101
1110101010101111101111111010111110111111101110101
1000100010100010001000000000000010100000100010101
1011111110111110111011111111111110101010111010101
1010001000100010100000100000000000101010000010001
1010101011101010101111101111111111101011101111101
1010100010001010100010001000000000101010001000101
1010111110101010101110111110101110111010111010101
1010000010101000101000100010100010100010100010001
1011111010101011101011101010111010101110101111111
1000100010101010001000001010100010001000100000001
1110101110101110111111111011101111111011111111101
1000100010101000000010001000101000000000000000101
1010111010101011111110101110101111111011111111101
1010100010100010000000100000100010001010000000001
1010101111111110111111111111101010101010111111111
1010100000000000100010001000001000101010100000001
1010111111111111101110101011111111101110101110111
1010000000000010000000100010100000100000100010001
1011111111111110111111111110101110111111111011101
1010001000000010000010000010100010000010000000101
1010101011111011111010111010111011101011111110101
1000101000001000100010101010000000101000001000101
1011101011111010101110101011111111101111101011101
1010001010000010101000100010000000001000101000101
1010111010111111101010101110111111111010101111101
1010100010000000101010101000100000000010100000101
1010101111111110101010101011101111101111111110101
1010100010000010001010101010001000001000100000101
1110111011101011111010101010111111111010101111101
1000100010001000001010101010000000001010001000001
1010101110111111101110101011101111101011111110101
1010100010000010100010101000100000101010000000101
1011111010111010111010101010111011101010111111111
1000100010001010001000101010100010001010000000001
1010101111111010111111101110101110111010111111101
1010101000000010100010001000100010000010100000101
1010101011111110101010111011111011111111101110101
1010001010001000001010100010001000100000001010001
1011111010101110111010101010101110101110111011101
1000100000100010001010101000101000100010001000101
1110111111111011101010111111101011111111101011101
1000000000000010001000000000001000000000001000001
1111111111111111111111111111111111111111111111111
