111111111111111111111
101000100000100000001
101010101110101111101
101010001010100010001
101011111010111010111
101010000010100010001
101011111010101111101
100010000010101000101
111110111110101110101
101000100010100000101
101010101010111111101
101010001010000000101
101011111011111110101
100010001000000010101
101110111111101010101
101000000010101010101
101011101010101110101
101010001010100000101
101110111010111111101
100000100000000000001
111111111111111111111
