1111111111111111111111111111111111111111111111111
1000000000100000000000000000001000000010000000001
1111111110111110101011111011111011101011101111101
1000000000100010101010001010001010001000100000101
1011111111101011101010101010101010111110111011101
1000001000001000001010101010100010100010100010001
1111101010101111111110101110111110101010111110101
1010001010101000001000100010000010101000001000101
1010111110111011101011111011111010111111101011101
1000100010000010100000001000001010000000100010001
1011101010111110111111111111101011111110111110111
1010001010001000000010000000100000100010100010001
1010111011101011101010111110111111101010111011101
1000100010001010001010000010100000001010001000001
1111101110111110111011111010101111111011101011111
1010001000000000100000001010001000100000001010001
1010111011111111101111111011111010101111101110101
1000100010000010001010000010000010001000101000101
1011111110111010111010111111111111111010111011101
1010001000101010100010100000000010000010000010001
1010101011101010101110101111111010111111111110101
1000100010001010101000100010000010000010000010101
1111111110101010101010111010111111111010111010101
1000100010100010001010001010000000000010001010101
1010101110111111101011111011111011111111101010101
1010001000100010001000000010001000100000101000101
1011101011101110111111111110101110111010101111101
1010001010001000100000001000101010000010100010001
1011111011101011111011111011101011111110111010111
1010001000100000000010000010101000000000001010001
1010101110101111111110111110101111101111111011101
1000100000101010000010100000100000101000000010001
1011111111101010111010101010111110111011111110111
1000001000000010001000101010100010001010000010101
1111101111111011101111101010111011101010111110101
1000100010001000101000001010000010001010100010101
1010111010101111101011111011111010111010101010101
1010001010100000001000001010000010100010001010101
1010101010111111111110111010111110111010111010101
1010101000100010000010100010001000100010001010001
1110111111101010111010101111101011101111111011101
1000100000001000101010100010101000101000001000101
1011101111101111101010111010101110101011101011101
1000101000001000000010101010001000100000101000101
1010101011111110111110101011111011101111101110101
1010001000000010100000101000000010001000100010001
1011111111111011101111101111111111111010111010111
1000000000001000000000000000000000000010000010001
1111111111111111111111111111111111111111111111111
