111111111111111111111
100010000010000000001
111010101011111011101
100010101000001010001
101111101111101011111
100010001000101000001
111010111011101011101
101000100010001010001
101111101110111110101
100000001000100010101
101110101011101010101
100010101000101000101
111010101110101111101
100010101010001000001
101110101011111011111
101000100000001000001
101011111111101111101
101010000000100000101
101010111110111111101
101000000010000000001
111111111111111111111
