111111111111111111111
101000001000100000001
101110101110101111101
101000100010001000101
101011111011111010101
101000001000000010001
101110101111111111101
100010100000100000101
111011111010101110101
101000001010101000101
101111101110101011101
100000100000101000101
111110111111101110101
100000001000001000101
101111101011111010101
100010001010000010101
111011111010111011101
100010001010100010001
101110101010111110111
100000100010000000001
111111111111111111111
