1111111111111111111111111111111111111111111111111
1000101000000000100000100000000010001000001000001
1110101011111110101010111011111010111010111011101
1010100010000010001010000010100010100010000010001
1010111011111011111011111110101110101111111110101
1010001000100000100010000000101000001000001000101
1011101110101111101110101111101011111011101011101
1000001000001000101000100000001010001010101010001
1011111011111010101011111111111010101010101010111
1000100010000010101010000000100010101010000010001
1110111010111110101010111111101111101011111111101
1010001010100010001010000000100000001000001000001
1011101010101111111010111110101111111111101011111
1010001010100000001010001010001000000010001010001
1010111110111011111011101011111011111010111010101
1010000010100010001010100000101010001000101000101
1011111010101110101010111110101010101111101111101
1010001000101000100010000010001010100000000000101
1010101111101011111110111011101010111111111011101
1000100000100010000000001010001010000000001010001
1011101110101110111111101010111011101111111010111
1010001000100010000010101010001000101000001000101
1010111111111011111010101111101110111011101011101
1010000000001000001000100000101010001000101000101
1011111110101111101110111110101011101110101110101
1010000010101000001000100010001000101000100010001
1011111010111011111110111011111010101011111011101
1000001010001010000010000010000010100010001000101
1111101011101011101011111011111010111110101110101
1000101000101000001000101010001010101000100010101
1010101110101111111110101010101010101011101110101
1010100000101000100000101000101010001010001000101
1110111110101010101111101111101011111010101011111
1000100000100010100010001000001000000010101000001
1011101111111110111011101011111111111110101111101
1010001000001010001000101000100000000000101000101
1010111011101010111110101110101111111111101010101
1010100010001010001000100010100000000010001010001
1010111010111011101011101010111111111010111011101
1010000010100000101010101000100000001010100010001
1011111110101111101010101111101111101011101110111
1000001000100010001010001000001000000010001000101
1111101011111010111010111111101011111110111011101
1000001000001010100010000000001010001000101010001
1011101111101010101111111111111011101011101010101
1010001000001010101000000010000000001000101000101
1011111011111010101011111011111111111110101111101
1000000000000010000010000000000000000000100000001
1111111111111111111111111111111111111111111111111
