111111111111111111111
101010000000000000001
101010111111101111101
101000100000001010001
101011101111111010111
101010001000000010001
101110111111101111101
100000100000001000001
111111101111101011111
100000001000001000001
101111101011111111101
101000101000101000001
101010101110101011111
100010101000101000101
101111101011101110101
101000001000000010001
111011111111111111101
100010000000000000001
101110111111111111111
100000000000000000001
111111111111111111111
