111111111111111111111
100010100000000000101
111010101111111010101
101010100010000010001
101010111010111011111
100010000010100010001
101110111110111010101
100010001010001010101
111011101011101110101
101010101010001000101
101010101010111011101
100010100010000000101
101110111011111111101
101000001000100000101
101011101110101110101
101010100000100010001
101010111111111011101
101000000000001000101
101111111111111110101
100000000000000000101
111111111111111111111
