1111111111111111111111111111111111111111111111111
1000000000001000000000000000000010000010000000001
1111111111101111111110111111111011101011101111101
1000001000101000100010000010000000001000101010001
1110101011101010101011111011111111111110101010111
1000101000100010001000001000000010000010100010001
1011101110111111111111101011111010111010111111101
1010001000100010000000101000001010101010100000001
1010111010101011101111101011111010101010101111101
1010000010001000001000001010000010001010100010001
1011111110111111111011111110111111111010111010111
1000100000100000001000100000100000000010001010001
1010111111101111101110101111101110111011101011101
1010100000001000100000100000101000100000101000101
1110101111111011111111111110101011101111101010101
1000101000000010000000000010101010000010001010101
1010101111101010111110111010101011111110111110101
1010100000101000100010001000101000000000100000101
1010111110101111101011101111101111111111101111101
1010100000101000101000001000001000100000100010001
1011101111101010101111111011111010111010111010111
1000101010000010101000100010000010000010000010001
1110101010111111101010101111101011111110111111101
1000101000001000001010101000101000100010100000101
1011101011111011111010101010111110101010101110111
1000001010000010000010100010000010001010101010001
1011111110111110101110111111111011101011101011101
1010000010001000101000100010001000101010001010001
1011101011101111101011101010101110101010111010101
1000001000100010001000001010100000101010001010101
1111111110111010111111111110111111101011101010101
1000000010100010000000000000000010001000101010101
1011111110101111111111111111111010111011101010101
1000000010100010000000100010000010001000000010101
1011111010111010111110101011111011111111111110101
1010001000100010100000101000001000100000000010101
1010101111101110101111101111101110101111111010101
1010101000100000100000000000100010101000001010101
1010101010101111111111101111111010101111101010101
1000100010101000000000101000100010001000001000101
1111111110101011111110111010101111111011101111101
1000100000101010001010001010101000000010100000101
1011101111101010101011101010101011111110111110101
1000001000001010100000100010001010000010000000101
1011111111111010111111111111111010111011111111101
1000100000100010001000001000000010001000000010001
1110101110101110101011101011101111101111111010111
1000001000001000100000100000100000000000001000001
1111111111111111111111111111111111111111111111111
