1111111111111111111111111111111111111111111111111
1000000000100000000010001000101000100000001000001
1111111110101110111010101010101010101011111010111
1000001000100010100000101010100010001000000010001
1011101011111010111111101010111111111011111110101
1010001000100010001000000010000010001010000010101
1010111110101111101011111111111010101110111011101
1010000000101000001000001000101000100010101010001
1011111111101011111011111010101111111010101010111
1010000000101010001010000010100000001010101010001
1010101111101010101110111110101110111010101011101
1010100000001010100000001000100010100010100010001
1011111111111010111111111011111010101110101110101
1000100000001010001000100010000010001000100010101
1110101111101011101010101110111111111110111010101
1010001000101010001010101010100010001000100010101
1011111011101010111011101010101010101011101110111
1010000000001000100010001010001000101010101000001
1010111111111011111010111011111111101010101011101
1010000000101010000010100000000000001010001010001
1011111110101011101110111111111110111011101110101
1010000010101010001000100000000010101000101000101
1010101010101010101011101111111010101010101011101
1000101010100010101000100010001010100010100010001
1011101010111010111110111010101010111110111110111
1000101010001000100000001010101010000010000010101
1111101011101111101011111011101011111011111010101
1000001000100000101010001000001000101000001010101
1011111111111110101110101110111110101111101010101
1000100010000000101000101000100000100000100010101
1110101010111111101011101011101111101111111110101
1000101010100000001010100010001010000000000010101
1011101010101111101010111110111010111111111010101
1010001000100000100000100000100010000010001000101
1010111111111110111111101111111011111010101111101
1010001000000000100000001010000000001000100000001
1011101111111111101111111010101111101111111111101
1000100000000000001000001000101000101010000010001
1010111111111111111010111011101010101010111010111
1010000000100000001010000000101010001010001000101
1011111010101011101111111111101011111011101111101
1000001010101000100000000000001010000000101000001
1011111011101110111111111111111010111110101011101
1010000010001010100000000010000000100010101000101
1010111010111010101111111011111110101010101111101
1010100010000010101000001010000010101010100010001
1010111111111010101110101010111011101011111010101
1010000000000010000000101000001000001000000000101
1111111111111111111111111111111111111111111111111
