1111111111111111111111111111111111111111111111111
1010100000100000000000100010000000000010001000001
1010101010101011111110101110101011111010101010101
1010101010101000001010100000101010001000101010101
1010101011101111101010101111101110101111101010101
1010001000001000101010101000100000100010001010101
1011111011111011101010111010111110111010111110101
1000001010000010001010000010000010100010100010101
1111101011111010111011111111111010101110101010101
1000001000000010100000000000101010101010001000101
1011111111111010101111111110101011101011111111101
1000100000100010100000000010001000001000100000101
1110101110101110111111111011111111111010101110101
1000100010001010000010001000100000000010100010001
1011111110111011111010101110101111101110111011111
1000000010000000101000100010001000100010001000001
1111111011111110101111111011111010111010111111101
1000000010100000100000101000001010001010000000101
1011111110101111101110101111101011101111111010101
1010000000101000101000001010001010100000100010101
1010111110101010101111101010111010111110101110101
1010001000100010101000100010000010000010100010101
1011111011111110101010111111111111101110101011101
1000001000000010101010100000100000001000101000001
1111101011101010101010101110101011101011111110111
1000001000101010100010000010001000101000000010101
1011111111101110111110111111111110101111111010101
1010000000101000100010001000100000101000001010001
1011111010101011101011111010101111101011101011111
1000001010001010001010000010101000101000101000001
1111101011111010111010111110101110101010111111101
1010001000001000101000101000100010001010000010001
1010111110101111101111101011111011101011111010111
1010000010100010000010001000001000101000100010001
1011111010101110111010101111101110101011101011101
1000001010100000100010100000100000101010001000101
1011101011111111101110111010111111101110111110101
1000100010000000100000101010001000100010001000101
1110111110111110111011101011111010111011101011101
1010001000100010001010001010001010000000001010001
1011101110101011101011101010101011111111111010101
1000001000101010001000101000100000100010000010101
1011111011101110111110101111111110101010111110111
1000000010000010001000001000000010101010000010001
1111111110111011101111111011111011101011111011101
1000100010101010001000000010000010001000001010001
1011101010101010111011111110111110111111101110101
1000001000001000000010000000000000100000000000101
1111111111111111111111111111111111111111111111111
