111111111111111111111
101000000000100000001
101111101110101111111
100010001000100000001
111010111011111111101
100010100010000000101
101110101110101110101
101000101000100010001
101110101011111011111
100000101010001010001
111111101110101010101
100000100000101000101
111110111111101011101
100000000010001010001
101110111110111010111
101000100000100010001
101011101111101111101
101000100010001000101
101111111011111010101
100000000000000010001
111111111111111111111
