111111111111111111111
101000100000000000001
101010101111111110101
101010100000000010101
101010111110111110101
101010100000100000101
101110101111101111111
101000101000100000001
101011101011111111101
101000101000001000101
101010101110101010101
101010100010101010001
101110111011101011101
100010000000001000101
111011111111101110101
101010001010001000101
101010101010111011101
101010101000001000101
101010101111111110101
100000100000000000101
111111111111111111111
