111111111111111111111
100000100000001000001
111110101111101110101
100010100000100010101
101110101110111010101
101000101000100010101
101011101011101110111
101000101010101000001
101110111010101111101
100010001010100000001
101111101010111111101
100000101010000000101
101010101011101111101
101010101010001000001
101011101010111011111
101010001010100010001
101010111010101110101
101010000010100000101
101011111110111111101
101000000000000000001
111111111111111111111
