1111111111111111111111111111111111111111111111111
1010001000001000000000001000000000001000000000001
1010101011101011101111101011111111101011111011101
1010101010100000100000100010000000001010001010001
1010101010111111111110111110111111111011101011101
1000101000001000000000100000101000001000001000101
1111101110111011111111101111101011101111101110101
1000101000100010000000101000100010001000001000101
1011101011101111101111101110101110111011111011101
1010001000101000001000100010000010000010001010101
1010111111101011111010111011111110111110101010101
1000100000001000100010001000100010100010100010101
1011101111111010101111101110101011101010111110101
1000001000001010101000101000101010001010100000001
1111111011111010101110101011101010111010101111111
1000100000000010101000100010001010101010101000001
1010101111111110101010111111101010101010111011101
1010100010001000100010001000001000100010000010101
1011111010111011111111101010111111101111111010101
1000000010001000001000001010000000100000001000101
1011111111101111101011111111101110111111101111101
1000000000000010101010000000101000100000100000001
1111111111111010101010111110101011101110111111101
1000100000000010100010100010101010001010000000001
1011101111111110111110101010101010111011111111111
1000101000000010000000101000101010000000001000001
1110101110111010111111101111101011111111101110111
1000101000100000100010100010001000100000100010001
1010101011111111101010111011111010101010111011101
1010101000001000001000001000001010101010100010001
1010101110101111101111101111101010101011101110101
1010100010100000101000100010001010101000001000101
1011111011111110101010111110111110101111111011101
1010001010001000100010100000100000100010000010001
1010101010101011101110101111101111111010111110111
1000101010100010000010100010001000001010100010101
1111101010111111111010111010111110101010111010101
1000101010000000100010001010100000101010100010101
1010101010111110111011101010111011101010101110101
1010101010000010001000101010001000101010100000001
1010101011111011101111101011101010111010111111101
1010101010000000100010001000001010100010000010001
1010101011111110111010111111111110101111111010111
1010001000100010001010000000000000100010000010001
1011111110101011111010111111111011111010111111101
1010001000101010000010001000001000000010001000001
1010101011101010111111101110101111111111101011111
1000100000001000100000000000100000000000001000001
1111111111111111111111111111111111111111111111111
