111111111111111111111
101000000000100000001
101010111110101111101
101010100000100000101
101010111110101111101
101010000010101000001
101111111010111011101
100010001010000010001
111010101011111110111
100010100010000010001
101110111110111011101
100010100010001000101
111010111011101110101
101010001000100010001
101011101110111011111
101010001000001000001
101010111011101111101
101000100010000010001
101111101111111110111
100000000000000000001
111111111111111111111
