1111111111111111111111111111111111111111111111111
1010000010001000000000100000001000100000000010001
1011101010101010111111101110101010101110111010101
1000101000100010100010001010101010001010100000101
1110101111111111101010111010101011111010111111101
1010100000000000101010001010101010001010000010001
1010101111111110101011101010111010101011111011101
1010100000000010001000000010000010100000001000101
1010111111111111111111111111111010111111101110111
1000100000000000000000000000001000100000001010001
1011101111111111111111111111101111101111101011101
1010000000001000000000000000100010101000100010001
1010111111101111101111111111111010101010111010111
1010000000100000100000000010000010101010100010001
1011111011111010101111111010111110101010111111101
1000100010001010101000100010000010001010001000101
1110111110101110101110101111111011111011101010101
1010000000100000101000101000001010000010100010001
1011111111111111101011101011101010111110111111101
1000000000001000001000100010100010001000000000101
1011111111101011111110111110111111101011111110101
1000000010001000100000100000001000001010000000101
1011111110111110101111101110101010111011111111101
1010000000100000101000001000101010001000100000001
1110111110101111101011111011101110101110101111111
1000100010101000001010001010100010100010000010001
1011101011101011101010101010111011111011111010101
1000001000101010100010101010000000001010001000101
1011111110101010111110101011111111101010101111101
1000001000101000001000101000000010001000100000101
1111101010101111101111101111111010111011111110111
1000001010101000000000100000100010100000000010001
1111111011101011111110101111101110101111111111101
1000001000101010001000001000001010100010001000001
1011101010101110101111101011111010111010101011101
1010001010100000100000101010100000100010100010001
1010111110111111111110111010101111111110111110111
1010000000000000000010000010100000000010001010101
1011111111101111111111111110111111111011101010101
1010001000001000100000100000000000001010001010101
1010101111101010101011101111111011101010111010101
1000100000101010001000001000000010001000100010001
1011111110111011111111111011101111111111101011101
1000001010100010000010001000101000000000001000101
1111101010101111101010101110101011111011111111101
1000100010101000001000101010101010000010000000001
1010111010101011111111101010111010111110111111111
1010000010000010000000000010000010000000000000001
1111111111111111111111111111111111111111111111111
