1111111111111111111111111111111111111111111111111
1000000000100000100000000000001000000000000000101
1111111110101111101110111111111011111111101110101
1000100000100000100010000010000010001000001010101
1010101111111010111011111010111111101011111010101
1010101000001010001010000010100000001000001010101
1110101011101011101010111110101011111110101010101
1000100010101000100010000000001010000010101000101
1011111110101011111111111111101110111011101011101
1010000000101010000000000010001000101000001010001
1010101110101110111111111010111011101111111011101
1000100010100010100000001010100010000010000010001
1011111010111010101011111010101111101110111110101
1010000010101000101010000010101000101000100000101
1110111110101111111010111110101010101011101011101
1000100010000010000010100010101010001000101000101
1011101111111010101110101010101011111110111110101
1010000000100010100010101010101010000010100000101
1011111010101111111010101011101010111010101111101
1000001010100010001010001000001000001010100010001
1111101011111010101011111111111111111010101011111
1000101010000000100000100000000010000010101000001
1010101010111111111011101110111010111110111111101
1010001000000010001010001000100010000010000000101
1011111111111110101010111011101111101011111110101
1000000010001000101010001010000000101000100010101
1011111010101011101111101011111110111010101010101
1010001000101000100000101000100010001010101010001
1010101111101110111011101110101111101011101011101
1010100010000010101000101010100000101000101000101
1010111010111110101110101010101011101110101110101
1010100010000010100010001010101010001000100010101
1010101111111010111011111010101010111010101110101
1000101000001000100000100010101010000010101000101
1111101011101111101110101010111010111111101011101
1000101000100000001000001010001000100000001010001
1110101010111111101111101111101111101111111010111
1000101010000000101000101000100010001010001000101
1011101011111110111010111010111010111010101111101
1010001010000010000010100010100010101000100000001
1010111011101011111110101110101110101011111111101
1000101000101010000010001000101000100010000000001
1011101110101011111011111011101011111010111111111
1000100000001000000010001000101010001010000010001
1110111111111111111011101110101010101111111010101
1000100000000010001000000010100010100010001000101
1011101111111010101111111110111110111010101111101
1000001000000000100000000000000000100000100000001
1111111111111111111111111111111111111111111111111
