1111111111111111111111111111111111111111111111111
1010000010000000000000000000001000000000001000001
1010101110111111111111111111101011101011111010101
1010100010100000001000000000101010101010000010101
1011111010101111101111111110101010101110111110101
1000001000001000001000001000101010100000001000101
1111101111111011111011101011101010111111111011101
1000100000100010000010101010001000100000001000101
1010111110111011101110101010111110101111101010101
1010000010001000001000100010001000100010101010101
1011111011101111111010101111101011111010101110111
1000101010001010001010001000001000001010100010001
1110101010111010101011111011111011111010111011101
1000101010100000100010001000000010000010001010001
1011101010101111111110111111111110111110111010111
1010000010100000100010000000001000100000001010001
1010111110111110101010111011111011111110101011101
1010001000100010101000101000001000000010100010001
1011111011101110111110101111101111111011101110101
1000000010000000100010001000100010001000100000101
1011111110111111101011101010101010101110111111111
1000100010000000001000100010101010100010000000001
1110101011111111111110101111101010111011111011101
1010101000000000100000101000001010100000001000101
1010101111111010101111111011111010111111101111101
1010100010000010101000000010001010001010001000001
1010111110111111101011111110111011101010111011101
1010100010100000001000100010001010001000100010001
1010101010101111111010111010101010111011101111111
1010101000101010000010001010100010100010000000001
1010101111101010111111101010111110101111111111101
1010100000001000100010001010101000100000100000001
1010101111111111101010111010101011111110101111101
1000100000100000101000101000001000100010101010001
1011111110111010101111101011111110101010101010111
1000100010000010001000001010100000101010001010001
1110101011111111111010111010101111101111111011101
1010001010000010001010000010100010000000001000001
1011111010101010101011111010111010111111101011111
1000000010101010100010001000001010000000100010001
1011111110101110111110101111101011111110111110101
1000100010100000000010100010001010000010001000101
1110101110111111111110111011101010111011101110101
1000100000100010001000100000101010100000100000101
1011101111101110101011111110111011101111111111101
1000100000001000101000000010001000100010000000101
1110111111111011101111111011101110101010111011101
1000000000000010000000000010000000101000001000001
1111111111111111111111111111111111111111111111111
