1111111111111111111111111111111111111111111111111
1010000000000000000000000010000000100000100000001
1011111110111110111111111110111010101110101011101
1000100000100000100000001000100010001000101010001
1110101111111110101111101011101111111011111011101
1010100000000010100000101010001010001000001000101
1010111111111011111011101010111010101111101110101
1010000000001000001010001010100000100000101000101
1011111111101010111010111010111111101110101011101
1000000000101010000010000010000000101000100010001
1011111011101011111111111111111110101011111110111
1000001010001000101000000000001010101000000000101
1011101110111110101011111011101010101111111111101
1010001000100010100010001000100010100010000000101
1010101011111010111010101110101110111010111010101
1010101010000010001010100000101000101010001010001
1010101010101111101010111011111011101011111011101
1010101010100000001010101010000010001000100010101
1110101010111111111010101010111110111110101110101
1000101010100000001010100010000010100010101000001
1011111010111110101010111111111010101010101011111
1000000010000010100010001000001010001010101000101
1011111111111010111111101011101011111010101110101
1000001000100010000010001010101000100010001000101
1111101010101111111110111010101110101111111011101
1010001010001000000000100010100000101000001010001
1010111011111011111011101110111111101011101010101
1010101010000010001010001000000000100010001010101
1010101010111010101110111011101111101110111011101
1000100000100010100000100000100000101010000010001
1011111110111110111111111111111110101011111110111
1010000010100000100000000000000000100010000000001
1010111011101111101110111111111111111010111111101
1010001000100010101010001000000010001010000010101
1010101110101010101011101011111010101011111010101
1010101000101010101000101010001010101010001010101
1011101011101010101010101010111010101010111010101
1000101010001010001010100010001000100010001000101
1110101011101010111110111111101111111110101110101
1010001000101010000000100000001000000010100000101
1011111110111011111110111110101011101011111011101
1000000010000010000010100000101010001000001000101
1110111111111111111010101111111010111111101110101
1000100000000000000010100000100010100000100010101
1011101110111111111110101110101110101011111011101
1010001000100000001000100010001000101000001000001
1010111011101111101011111111111011101110111111101
1000001000000000100000000000000010000010000000001
1111111111111111111111111111111111111111111111111
