■S■■■■■■■■■■■■■■■■■■■■■■■■■■■■■■■■■■■■■■■■■■■■■■■■■
■   ■       ■         ■   ■     ■     ■         ■ ■
■■■ ■■■ ■■■■■ ■■■■■ ■ ■ ■■■ ■ ■■■ ■■■ ■ ■■■ ■■■ ■ ■
■ ■   ■       ■ ■   ■ ■     ■     ■   ■ ■   ■ ■ ■ ■
■ ■■■ ■ ■■■■■■■ ■ ■■■ ■ ■■■■■■■■■■■ ■■■ ■ ■■■ ■ ■ ■
■ ■   ■ ■       ■ ■   ■   ■     ■   ■   ■ ■     ■ ■
■ ■ ■■■ ■ ■■■ ■ ■ ■■■ ■■■ ■ ■■■ ■ ■■■ ■■■ ■■■■■ ■ ■
■   ■ ■ ■   ■ ■ ■   ■   ■ ■ ■ ■ ■ ■   ■ ■     ■   ■
■ ■■■ ■ ■■■■■ ■■■■■ ■■■ ■■■ ■ ■ ■ ■ ■■■ ■■■■■ ■■■ ■
■ ■   ■     ■   ■   ■       ■   ■ ■     ■ ■   ■ ■ ■
■ ■ ■■■■■■■ ■■■ ■ ■■■■■■■■■■■ ■■■ ■■■■■ ■ ■ ■■■ ■ ■
■ ■ ■   ■       ■       ■   ■   ■     ■ ■ ■   ■   ■
■ ■ ■ ■ ■ ■■■■■■■■■ ■■■ ■ ■■■■■ ■ ■■■ ■ ■ ■■■ ■■■ ■
■ ■   ■   ■ ■     ■   ■ ■       ■   ■ ■     ■   ■ ■
■ ■■■■■■■ ■ ■ ■■■ ■■■■■ ■ ■■■■■■■ ■■■ ■■■■■ ■■■ ■■■
■       ■ ■ ■ ■ ■ ■     ■   ■   ■ ■   ■ ■   ■ ■   ■
■■■■■■■ ■ ■ ■ ■ ■ ■ ■■■■■■■ ■ ■■■ ■ ■ ■ ■ ■■■ ■■■ E
■ ■     ■   ■ ■     ■     ■ ■   ■ ■ ■   ■ ■   ■   ■
■ ■ ■■■■■■■ ■ ■■■■■■■ ■■■■■ ■ ■ ■ ■ ■■■■■ ■ ■ ■ ■ ■
■   ■     ■ ■   ■   ■ ■   ■ ■ ■   ■         ■ ■ ■ ■
■ ■■■ ■■■ ■■■■■ ■ ■ ■ ■ ■ ■ ■■■■■ ■■■■■■■■■■■■■ ■ ■
■     ■ ■     ■   ■ ■   ■   ■   ■ ■ ■           ■ ■
■■■■■■■ ■■■■■ ■ ■■■ ■■■■■ ■■■ ■ ■ ■ ■ ■■■ ■■■■■■■ ■
■     ■     ■ ■   ■     ■ ■   ■ ■   ■ ■   ■   ■   ■
■ ■ ■■■ ■■■ ■ ■■■■■■■■■ ■ ■ ■■■ ■■■ ■ ■■■■■ ■ ■ ■■■
■ ■       ■ ■       ■   ■   ■ ■   ■ ■       ■ ■   ■
■ ■■■■■■■■■ ■■■■■■■ ■ ■■■■■■■ ■■■ ■■■■■ ■■■■■ ■■■ ■
■       ■   ■   ■   ■       ■   ■     ■   ■   ■ ■ ■
■■■ ■■■■■ ■ ■■■ ■ ■■■ ■■■■■ ■ ■ ■■■■■ ■■■ ■ ■■■ ■ ■
■ ■ ■     ■ ■   ■   ■ ■     ■ ■     ■   ■ ■ ■   ■ ■
■ ■ ■ ■■■■■ ■ ■ ■■■ ■ ■ ■■■■■ ■■■■■■■■■ ■■■ ■ ■ ■ ■
■ ■ ■ ■   ■ ■ ■   ■ ■ ■ ■   ■   ■     ■     ■ ■   ■
■ ■ ■ ■ ■ ■ ■ ■■■ ■ ■■■ ■ ■ ■ ■ ■ ■ ■■■■■■■■■ ■■■■■
■   ■ ■ ■ ■   ■   ■     ■ ■ ■ ■   ■         ■ ■   ■
■■■■■ ■ ■ ■■■■■ ■■■■■■■■■ ■ ■ ■■■■■■■■■■■ ■ ■ ■ ■ ■
■     ■ ■ ■     ■         ■ ■ ■   ■       ■ ■   ■ ■
■ ■■■■■■■ ■ ■■■■■ ■■■■■ ■ ■■■ ■ ■ ■ ■■■■■■■ ■■■■■ ■
■       ■       ■ ■     ■ ■   ■ ■ ■ ■     ■     ■ ■
■■■■■■■ ■■■■■ ■■■ ■ ■■■■■■■ ■■■■■ ■ ■ ■■■ ■ ■■■■■ ■
■       ■   ■ ■   ■         ■     ■     ■ ■ ■   ■ ■
■ ■■■■■■■ ■ ■■■ ■■■■■■■■■■■■■ ■ ■ ■■■■■■■ ■ ■ ■ ■ ■
■       ■ ■     ■           ■ ■ ■ ■   ■   ■ ■ ■ ■ ■
■ ■■■■■ ■ ■■■■■■■■■■■ ■■■■■ ■■■ ■ ■ ■ ■ ■■■■■ ■ ■ ■
■   ■ ■   ■         ■   ■ ■     ■ ■ ■   ■   ■ ■ ■ ■
■■■ ■ ■■■■■■■■■■■ ■ ■■■ ■ ■■■■■■■ ■ ■■■ ■ ■ ■ ■ ■ ■
■ ■           ■   ■     ■   ■   ■ ■   ■ ■ ■ ■ ■   ■
■ ■■■■■■■■■■■ ■ ■■■■■■■■■ ■ ■ ■ ■ ■■■ ■■■ ■ ■ ■■■■■
■     ■   ■   ■ ■       ■ ■ ■ ■   ■ ■     ■   ■   ■
■ ■■■ ■ ■ ■ ■■■ ■ ■■■■■ ■ ■ ■ ■■■■■ ■■■■■■■■■■■■■ ■
■   ■   ■       ■     ■   ■                       ■
■■■■■■■■■■■■■■■■■■■■■■■■■■■■■■■■■■■■■■■■■■■■■■■■■■■
