1111111111111111111111111111111
1000100000000000001000001000001
1110101111101110111010101011111
1000101000001000100010100010001
1011101011111011101110101110101
1000101000101010001010101000101
1110101110101010111010111011101
1000101000100010000010001000101
1011111010111111111011101110101
1000001010100000100010100000101
1111101011101110101110111111101
1000001000001000100010001000001
1011111111111010111011101011101
1010000000001010001000001000101
1010111111101011111111101110111
1000100000001000000000000010001
1111101111111111111111111011101
1000101000000000001000001000101
1010101111101011101011101111101
1010100000101010000010000000001
1011111110101011101111111111111
1000100000101000101000000000001
1010101111101110111011111111101
1010001000000010000000000000101
1011111111111011111111111110101
1010001000001000100000001000101
1010101011101110101111101111101
1010100010100010100010100010001
1010111110111011111010111010101
1000100000000000000010000000101
1111111111111111111111111111111
