1111111111111111111111111111111111111111111111111
1000100000100000000000000000000000000010000000001
1110101010111110111010111111111111111011111110101
1000101010000010001010100010000000101000000010101
1011111011111011101010101010101110101111111011101
1000001000001000101010101010101000100000001000101
1111101011101110101011101010101110101011111110101
1010001000100010101000001010100010001010000000101
1010111110111010111011111011101011111010111111101
1010001000100010001000001000101000100010001000101
1011101111101111101111111010101110111011101010101
1000101000001000100010001010101010001000100010001
1010101011111010111010101110101011101111111111101
1010100010001010001000100000100000100000000000101
1011111110101011101111111111111110111111111010101
1000000000101010001000000010000010001000001010101
1011111011101010111010111011101110111011101010101
1000100010001010100010001000001000100010001010101
1110101110111010111111101111111011101110111011101
1010101000100010000000100000000000101000100010001
1010101110101111111110101111111111101011101110111
1000100010100010000010101000000000101000001000101
1011111010111011101110101010111110101111101011101
1010001010000010001000101010100010001000001000101
1010101011111110111011111011101011111011111110101
1010101010000000000010001010001000001000100000101
1010111010111111111110101010111111101110101111101
1010100010000000100000101010101000001000101000001
1010101111111110111011101010101011111011101010101
1000100010000010000010000010101000001010101010101
1110111010111011111011111110101111101010101110111
1010101000100010100010000000101000001000100010001
1010101111101110101110111111101011111111111011101
1000100000100010000010000000101010000000001000101
1011101011111011111111111110101010111111101110101
1000101010001010000000001010001000100000101000101
1110101110101010111110101011101111101010101011101
1000101000101010100010101000100010001010101000001
1011101011101010101010101011111010111011101111101
1000100000101000101000100010000010100010001010001
1110111111101111101111111110111110101110101010111
1010000000100000100000001000100010101000100010001
1011111110101111111111101011101010101011111011101
1000001000100000000010101000101000101000001000101
1010111011111110111010101110111011101111101111101
1010001010000010101000100010001000100000100000101
1011101010111010101110111011101111111010111110101
1000100000100000100000001000000000000010000010001
1111111111111111111111111111111111111111111111111
