1111111111111111111111111111111
1000001000001000000010000010001
1111101111101011111010111010101
1000100000101010000010101000101
1011111110101010111010101111101
1000000000100010001010001000001
1011111111101111101111101011101
1010100000101000100000001010101
1010101110101010111111111010101
1010001000101010000000001010001
1010111010101111111111101011101
1010001010100010001000001000101
1011101011111010101011101110111
1000101000001000101010101010001
1110101111101111101010101011101
1000100000100000101010101010001
1011111011101110101010101010101
1000101010001000100010100010101
1110101010111110111110111010101
1010100010100010000010100010101
1010101110101011111010101110101
1000100010001000100000100010101
1011111110111110111111111010111
1010000010001010001000001010001
1010111011101011101010101011101
1000101010100000100010101010001
1111101010111011111110111010101
1000000010000010000010000010101
1011111111111110111011111110101
1000000000000000100000000000101
1111111111111111111111111111111
