1111111111111111111111111111111111111111111111111
1010001000000010000000001000001000100000100000001
1010101011111011111110101011101010101110101111101
1010101010001000100000100010100010001010100000101
1010101010111110101111111110111111111010111110101
1000100010000010101010000000001000000010001000101
1111111110101110101010111111101011101111101111101
1010001000100000101000101000001000101000001000101
1010101011111111101011101011111011101011111010101
1010100010001000001000001000100010001010000010001
1010111110101110111111101110101110111011111011111
1000100000100010000010101010001010000010001000001
1011111011111011111010101011111011111110101111101
1000000010100010001010001000000000100000100000001
1111111110101110101010111011101111101011111111101
1000001000100010100010101010100000001000001000101
1010101011111010111110101010111111111011101110101
1010101000001010001000100010000010001000100010001
1010101111101011101011111011101110101111101011101
1010100000001000001000001000001000100000101000101
1010111011111111111111101111111011111110101110111
1010101010000000000000100000000010000000101010001
1110101010111011111111111111111110111111101011101
1000100010001000100000000000100010001000100000101
1011111111101110101111111110101011101010111111101
1000000000100010100000001010101000001010000010001
1011111110111010111111101010101111111011111010101
1010000010001010000000100010100010000010001000101
1010111010101011111011111010111011111010101111101
1000100010101000100010001010001010001000101010001
1111101110101110101110101011101010101110101010111
1000101010101000100000100010100010100010101010001
1010101010111011111111111110111110111011101011101
1010100010001010000010000000000010101000001000101
1010111011101010111011111110111010101111111110101
1010001000101000101000000010101000101000000000101
1010111110101111101111111010101111101011101011101
1010001000100000100000001000101000001000101010001
1011101011111110101110101111101011101110101110111
1010100010100010001010100010001010100010100000101
1010111110101011111010111011101010101110111111101
1000001000001000000010101010001010100010000010001
1111101111111011111010101010111010111011111010111
1000100010001000101010100000100010001000001010001
1011111010101010101010111111101111101110111010101
1000001010101010101010001000100000000010001010101
1010111010101110101011101010111111111011101011101
1010000000100000100000100010000000000000100000001
1111111111111111111111111111111111111111111111111
