1111111111111111111111111111111
1010000000100000100000001000001
1011101010101110101110111010111
1000101010001010100010100010001
1110111011111010111110101111101
1010001000100010100010001000101
1011101010111010101011111010101
1000101010100010101010000010001
1110101110101010101010111111101
1000100010101010001010001000001
1010111010101111111011101011111
1010100010100000001000001000001
1010101110101111101111101111111
1010101000101000100000001000001
1011101011101010111111111011101
1000001000101010000010000010001
1011111110101011111110111110101
1000000010100010000010100010101
1111111010111010111010101010111
1000001010100010001000001010001
1011101010111111101111111111101
1000100010100000001000100010001
1110111110101111111110101010111
1010100000101000100010101010001
1010111110101010101010101011101
1010000010000010001000101010001
1011111011111111101111101010111
1010001010001000101000101010001
1010101010101010111010101011101
1000100000100010000010001000001
1111111111111111111111111111111
