1111111111111111111111111111111
1000000000101000000000000000001
1111111110101011111111111111101
1000000010101010001000000000101
1010111010101010101110111110101
1010001010100010100000100000101
1011101010111010111111101111101
1010001010001000101000100000101
1010111111101111101010111110101
1010000000001010000010001000101
1011111111111010111110101011101
1000100000001000100010101010001
1110111110101011101010111010101
1010000000101010001010100010101
1011111111101011111010101110111
1010000000101000001010001010001
1010111110101111101011111011101
1000001000101000101000100000101
1111111011101011101010101111101
1000100010001000000010001000001
1010101110111111111111101011101
1010100010100000000000101010001
1010111010101111111110101011111
1010100010100010001000101000001
1010101010111010101011111011101
1010001010100010101000001010001
1011111010101110101111101110101
1000100010100000100000100000101
1010111110111111111110111111101
1010000000000000000000100000001
1111111111111111111111111111111
