1111111111111111111111111111111111111111111111111
1000001000100010000000001000001000000000100000001
1111101010101010111011101010101011111110111110111
1000101010001000101000101010101000101000100010001
1110101011111111101110101010101010101011101011101
1000101010000000001000101010101010100010001000101
1011101010101111111011101110101110101111101110101
1000001010100000100010001000100000100000101010101
1011111011111010101110111011111111111110101010101
1010000000001010101000100010100000000010001010101
1011111111101110101011101110101111111011111010101
1000000010001000101000001000101000001000000010001
1111111011101011101111111010101011101011111011101
1000001000100010001000001010001000101000001000101
1111101110111010111011101011111010101111101111101
1000000010001010100010001010001010101000100000001
1011111011101110101111111010111010101110111111111
1010001000100000100000100010001010100000000000001
1010101011111111101110101111101010111111111111101
1010100010000000000010100000100010100000000000101
1011111110111111111110111110111010101110111110101
1000000010000010100000100010001010100010100010101
1011111011111010101111101011101010111010101010101
1000001000000000101000001000101010100010001010101
1110111110111111101011111110101110101111111010101
1000100010000010001000100000100000101000001010101
1011101011111010111011101011111111101011101011101
1010001000100010000010001010000010001000101000001
1010111110111111111110101110101110111010101111111
1010001010000010001000101000101000100010100010001
1111101011111010101011111011101011101110111011101
1000101000001010100010000010100010001000100000001
1010101111101010101110111110111111111011111111101
1010100000100000101000100000001000000010000000101
1010111110111111101011111111101010111110111110101
1010000010001000001010000000100010001000100010101
1011111011101011111010111110101111101011101010111
1000001010001010001000100000101000100010001010001
1111101010111010101111101111111010111010111111101
1000001010001000100010001000000010001000100010001
1011111011101111111110111010111111101110101010101
1010000000001000001000100010100000100010101000101
1011111011111011101011101110101111111010101111101
1000001010000010001010001000101000001010101010001
1011101110111110111010111011101010111011101010111
1000100010001010000010100010100010000010001010101
1110111011101011111111101110101111111110111010101
1000001000000000000000001000000000000000100000001
1111111111111111111111111111111111111111111111111
