1111111111111111111111111111111
1000100000000000000000100000001
1110111111111111111010101011111
1010000010001000001010001000001
1011111010101011101111111111101
1000001000101010001000100000001
1110111111101010111010101111101
1000100010001010000010001000001
1011101010111011111111111011111
1000001000100010100010000010001
1011111111101110101010111111101
1010000000101000001000100000001
1010111110101011111111101111111
1010100010101010000010000010001
1010101010101010111010111010101
1010001010001010101000101000101
1011111011111010101111101111101
1000001000100010001000000000101
1111101110101111101010111111101
1000101000100010001010100000001
1010101011111010111110101111101
1010101010100010100010100010001
1010101010101110101010111010111
1010100010100010001000100010001
1010111110111010111111101111101
1010000010000010100000101000101
1011111010111111101110101010101
1010100010000000001010001010001
1010101111111111111011111011111
1000100000000000000000000000001
1111111111111111111111111111111
