1111111111111111111111111111111111111111111111111
1010000000001000000000000000000000001000000000001
1010111111101010111111111111111111101110111111101
1000100000101010100000000000000000100010100000101
1111101110101010101111111111111110111010111011101
1000001010001010100000001000000000101000100010001
1011111011111011101111111011111111101111101110111
1000100000001000001000001010000010001000100010001
1110101111101011111011101010101010111010101011101
1000100000101010000010000010101000100010001010001
1011111110101010111111111110101111101111111010111
1000000000101010001000100000100000001000101010001
1111111111101111101010111110111111111010101011101
1010000000100010001010000010001000000010001000001
1010111110111010101011111011101011111011111111111
1010100010000010101010001000101000100010000000001
1010101111111110111010111110101110101110111011111
1000100000100010000010000010100010100000001000001
1011111110101010111110111010111011101111101111101
1010000010001000100010001010001000101000100000101
1010111010111111101011101011101110111010111110101
1000101010100000101000101010001010000010100000101
1111101010111010111110101010111011111110111111101
1000001010000010100010001010100000001000100010001
1011111011111110101010111010111110101011101010101
1000100010000010101010100010000010101010001000101
1110101111111010101011101011111010111010111111101
1000100000001000001000001010001010000010100000101
1011111111101111111111111010101011101110101011101
1010000000100000101000001010101000100000101000001
1010111010111110101011101010111110111111101111111
1010001010001000100000100000100000100000101000001
1011101010111011111111111111101111101111101010101
1000001010100010000000100000001000001000001010101
1011111010101110111110101111111110111011111010111
1010001010101000100000001000000000100010100010001
1011101011101110111111111011111110101110101111101
1000001000100010000010000000001000101000001000001
1111101110111011101010111111101011101111111011111
1000000010001000101010001000101010100010001000001
1011111111101110111011101011101010111010101111101
1010000000100010001000101010001000001000101000001
1110111110111011101110101010111111101111101011101
1000100000000000100000101010100000101010001000101
1011111111101111111111101010101011101010111010101
1000000000101000000000101010101000000010100010101
1011111110111010111111101010111111111110111110101
1000000010000010000000000010000000000000000000101
1111111111111111111111111111111111111111111111111
