1111111111111111111111111111111
1010000010000000001000001000001
1010111011111110101110101011101
1010101000000010100000101000101
1010101111111010111111101010111
1000100000001000100000101010001
1111111111101111101111101011101
1000000000000000100000001000101
1111101111111011101111111011101
1000001000001010001000100010001
1011111111101010111010111110111
1010000000101010000010000010001
1010111110101011111111111011101
1000100000100010000010001010001
1111101111101110111010101010101
1000101010001000001010101010101
1010101010111011101011101010101
1010001010100010001000001000101
1011111010111110111110111111101
1000001000000010000010100010001
1011101111111011101011101010111
1010100000101000101000001010101
1010111110101110111111111010101
1010001010100010100000001010001
1010101010101110101111101011101
1010101010100000001000000010001
1010101010111111101111111110111
1010101010100010001000100000101
1010101010101011111010101111101
1000100010001000000010000000001
1111111111111111111111111111111
