1111111111111111111111111111111
1010000010000010000000100000001
1011101011101011101110111011101
1010001000001000001010001000101
1010111111111111111011101010111
1000100000001000100000101010001
1111101111101110101011101111101
1000001000100010001010001000101
1011111011111011111010111010101
1010001000001000000010100010001
1010101011101111111010101111101
1010100010000010000010001000101
1011111110111010111111111011101
1000001000100010000010001000101
1011101011111011111010101010101
1000101000001010001010100010001
1111101011101110101010111111111
1000001000100010100010100000101
1011111111101010111110101010101
1000100000101000001000101010101
1010101110111111111011101010101
1010001010100000000010001010001
1011111010101111111110111011101
1010000010101000000010100010001
1010101110101010111110101110111
1010101000101010000000100010001
1011101011101011111011111011101
1010001000001010001010001010101
1010101111111110101110101010101
1000100000000000100000100010001
1111111111111111111111111111111
