1111111111111111111111111111111111111111111111111
1010000000100010000000000000100000100000000000001
1011101110101110111110111110111010111110111110101
1010001000100000100010100000100010100010001000101
1010111011101111101010111011101110101011111011101
1000100010100000001010001010000010001000100010001
1111101110111111111011101011111011111110101111111
1000101000100010000000101000001000101000100000001
1010101011101010111111101111101110101011111111101
1010001000001000100000101000100000101000000000101
1011111011111111101110101011111111101111111110101
1010000010000010001010101000000000000010000010001
1011111110111010111010101011111110111110101111101
1000001000101000100010001000100010100000100000101
1111101011101111101011111110101010101111111110101
1010001000100000001000000010101010000000001000101
1010111010101111111111101110101011111110111011101
1000100010101000001000100000101000001000100010001
1011101110111011101010111110101111101111101010111
1010001000100010101010000010100010001000101010001
1011101011101110101011111011111010111010101111101
1000101000001000101000100010000010100010001000101
1110101111111010101110101110111110111010111010101
1010101000100010100000100010001010100010100010101
1010101010101110111111111011101010101111101110101
1000100010001010100010001000000010100010001000101
1011111111111010101110101110111110111010111010101
1000000000001010100010100010100010001000100010101
1111111111101010111010111011101011101111101110101
1000000010001000100010101010001000001000001010101
1011111010111011101110101010111111111011111010101
1000101000100010001000100000101000100010000000101
1110101111111010101011111111101010101011111110101
1010100010001000101000001000000010101000000010101
1010101010101111101111101011111010101111111010101
1010101010100010000010001010001010001000001010101
1010101010111011111010111110101011111110101011101
1010001000101000100010000000101000000000101000001
1011111111101110111110111111101111111111101111111
1000000010000010000010000000101010000000101000101
1011101010111011111011101111101010101111101010101
1010001010100010001010001000101000101000001010101
1110111010101110101010111010101111101011111010101
1000100010101000100010100010100000101000100010101
1011101110101011111111101110111110101110101010101
1010000000101000100000001010100000101000101010001
1011111111111110111011111010101111101011111011101
1000000000000000000010000000001000000000000010001
1111111111111111111111111111111111111111111111111
