1111111111111111111111111111111111111111111111111
1000000010100000000010000000100000000000000000001
1111111010101110111110111010101111111111101110111
1000001010000010000000100010100010000000100010001
1011111011111011111110101110111010111110111011101
1000001000001000100010100010001010001010001000101
1111101111101111101011101011111011101011101111101
1000000000101000001000101010000010001010001000001
1011101111101011111110111010111110111010111011111
1000101000001010000010001000100000100000100000001
1010111011111010111111101111101111111011111111101
1010100010000010001000100000100000001000000000001
1110101110111111101010111110101111101111111111101
1000100000100000001010000010101000100000000010001
1011111111101111111011111010101010111011111011111
1010000000001000000000001010101010001010001000001
1010111111101011111111111010101011101110101110101
1000001000001000100010001010101000101000100010101
1011111010111110101010101010111110101011111011101
1010000010100010101000100010000000101010001000101
1010111110101010101111111111111111101011101110101
1010001000101000101000000000100000001000101000101
1111101011101111101011111010101111111110101011101
1000001000100000101000101010101000000000101000001
1011111110111110101110101011101011111111101111101
1010000010100010100010001000001000100000001000001
1010111011101010101011101111111110111110101011111
1010001000001000101010001000001000100010100000001
1011101111111111101010111011101011101011111111101
1000001000100000001010000010001000001010001000101
1111101010101011111111111110111111111010101011101
1000101010101010000000000010000010001000101010001
1010111010101010111111101111111010101110101010111
1010000010001010100010100000001000100010101000001
1011111110111110101010111110111111111011101111111
1000100010100010001000000010000000101000100000001
1110101010101011111110111111101110101110101111101
1000101000101000100000100000001000100010100000101
1011111111101010101111101111111011101110101111101
1000000010001010101000101000001000001000101000001
1011111010111011101011101011111111101011101011101
1000101000101000101010001000000000001010001000101
1110101111101110101010111011111111101011111110101
1010001000001010001010100010001000101000000010101
1011101011101011111010111011101010111111111010101
1000100010101000000010001000001010000010001000101
1010111110101111111011101111111011111010101111101
1010000000000000000000100000000000001000100000001
1111111111111111111111111111111111111111111111111
