1111111111111111111111111111111
1000000000100010001000000000001
1111111110101010101010101111101
1010000010101000101010101000101
1010101110101111101110111010101
1000100000101000001000100010101
1011111111101111101010101110101
1000001000000000101010101000101
1111101111111110101011101011111
1000100000001000101000001000001
1010111111101011101110111111101
1010000010001010100010000000101
1011101110111010111011111111101
1010001000100010001000000000101
1010111011101110101111111110101
1010100010001000100000100010001
1011101111101111111010101011101
1010001000001000000010101000101
1010111011111011111110101110101
1000100010000010001000100010101
1011111010111110101011111010101
1010000010001000101010100010001
1011101111101011111010101111111
1000001000101000001010101000001
1111111010101011101010101111101
1000000010001000100000100000001
1011111011111111111111111111101
1000001010001000000000001000101
1011101110101011111110111010101
1000100000100000000010000010001
1111111111111111111111111111111
