1111111111111111111111111111111
1000100000000000100010000000001
1110101011111110101110111110101
1000101010001000100000100010101
1011111010111011101111101010101
1010000010000010001000001010101
1010111110111110111011111010111
1000100000101000000010000010001
1111101111101011111011111111101
1000101000000010001010000000001
1010101011111110101110111111101
1010101010001000101000100000101
1011101011101011101011101111101
1000001000001000101000101000101
1011111011111110101110101010101
1000001010000000100010100010101
1111101110111111111010111010101
1000100010001000001010001010001
1010111011101010111011101011111
1010001000101010001000101000101
1111101110101011101110101110101
1000100010001000100010100010001
1010111011111011101110101011101
1010000000001010001000101010001
1011111011111010101011111010111
1010001010001010101000000010001
1011101010101010111111111111101
1000100010100010000000000000001
1010111110111111111111111111111
1010000000000000000000000000001
1111111111111111111111111111111
