1111111111111111111111111111111111111111111111111
1000000000000010000000000010000000000010000000001
1111111111111010111111101110111110101110111111101
1000000000001010001000100000101000101000000000101
1011111110111011101010111111101011101011111111101
1010000000100010001010001000001000101010000000001
1010101111101110111110101110101110111010111111101
1010101000101010000010100000101000100010001000101
1010101010101011111010101111111010101111101011101
1010101010001000001010101000000010100000101000001
1110101011111110111010101010111111111011101111101
1000101010000010001010101010100000001010001000101
1011101011101011101010111011101111101010111010111
1010001000101000100010001000101000100010100010001
1011111110101110101111101110101110111110101111101
1010000010101000100000000010100000000010001000001
1010101010101011101111111110111111111011111011101
1000101010001010101000000010000010000000001000101
1011101111111010101011111011101010111111111110101
1000100000001010001000100000101000100010001000101
1110111011111011111010111110111111101010101011101
1010001000000010001010001000000000101000101000101
1011101111111110101110101111111110101111101110101
1000100010000000100010100000001010101000101000101
1011111011111110111011111111101010101010101011101
1000000010000000101000100000001000100010101010001
1011111110101111101110101111111011111110101010111
1000000010101000100000001000001000100000100010101
1111111010111010111111111010101110101111111110101
1000100010000010000010000010100010100000001010101
1110101110111111111011111010111010111110101010101
1000101010000000001010001010100010000010101010001
1011101011111111101010101010111111111011101011101
1000101000000000001010101010000000001000001000101
1010101011111111111010101111101111101111111011101
1010001010000010000010100000101010000000100010001
1011111110111010111110111110101010111111101010111
1000100000101010000000001000100010001000001000101
1110101111101011111111111011111011101011111111101
1010001000001000100000000010001010100010000000001
1011111111101110101111111110101010111111111111101
1000000000100010001010000010100010000000100000001
1010111110101011111010111010111111101110101111101
1010100000001010000000100010000000001000100010001
1110111111111110111111101011111111111011111010111
1000100010000010100010001000000010000010001010001
1011101010111010101010111111111110111110101011101
1000001000001000001010000000000000000000100010001
1111111111111111111111111111111111111111111111111
