1111111111111111111111111111111111111111111111111
1000000000000010000000000010000010000010001000001
1111111111111010101111111010101010111010101011101
1000100000001010100000001010101010101010100000101
1010101011111010111111101010101010101011101111101
1010101000100010100000001010101010101000100010001
1010101110101110101111111011101010101110111010111
1010100010101010100010001000001000100010001010001
1011111010101010111010111111111111101111101011101
1000000010101000100010000000100000100000101010001
1111111110101011101110111011101110101011101110101
1000000000101010001010001010001010001010001000101
1010111110101110111011101010111011111010111011101
1010100010100000100010101000100000001010100010101
1010101011111111101010101111111111101010101110101
1010101000000000001000100000001000001010001000001
1011101111101111111110111111101011101011111011111
1000101010001000000010001000001010001000001000001
1010101010111011101011101011111011101011111111101
1010000010001000101000101000100000101010000000001
1011111111101111101110101110111110101010111111111
1000100000101000001010100010000000101000100010001
1111101110101011111010111011111111101111101011101
1000101010001010000000100010000010001000001010001
1010101011111011101111101110111010111110111010111
1010001000001000101000001000100010100000101010001
1010111111101010111011111111101010101111101011101
1010100000100010000010000000001010101000100000001
1011101110101111111110111111111010101110101111101
1010001000101000000000100000000010100010001000101
1010111011101011111011101111111110111011111010111
1000001010001000100010001000000010100010000010001
1111111010111111101110111110111010101110111111101
1000000010100000101010000000100010100000000000101
1011111110101110101011111111101110111111111110101
1000100010100010001000001000000010100000100010101
1010101110111011111010101011111110101110101010101
1010100000000010001010101000100000101010101000101
1010111011111110111010111011101111101010111111101
1010001000100010001010001010001000001000000000001
1011101111101010101011101010111010111111111111101
1000101000001010100000100010100010100000101000001
1011101011111010111111111110111110101110101011111
1010001010001010000010000010000010000010100000001
1010111010101011111110111011111010111110111111101
1010100010101000001000101010001010100010001000001
1010101111101111101011101010101011101011101011111
1010000000000000100000001000100000001000001000001
1111111111111111111111111111111111111111111111111
