1111111111111111111111111111111
1000001000100000000000100000001
1111101010111111111010111110101
1000001010000010001010001000101
1011111011111010101011101011101
1010000010001000100010100010001
1011101010101111111110111110111
1000101010100000100010001000101
1110111010101111101010101011101
1010000010100000101000100010001
1011111110111110101111111110101
1010000010001000101000000010101
1010101111101011101011111011101
1000100000101000101010001010001
1111111110101110101010101010101
1000001000101010001000101000101
1011101010101011111110101111101
1010100010101000000010100000101
1010111110101111101011111010101
1010001000100000101000001010101
1011101011111110101111101010101
1000100000100010100000101010101
1010101111101010101110101110101
1010101000001000101000100000101
1010111011111111101010111111111
1010100010000000101010100000001
1110101110101110101011101111101
1000100010101010101000000000101
1011111011101010111111111111101
1000000000001000000000000000001
1111111111111111111111111111111
