1111111111111111111111111111111
1000000010001000000000000000001
1111111010101110111011111111101
1010001000100010001000100000001
1010101111111011111110111110111
1000100000001000100000100010101
1011111010111110101111101010101
1010001010100000100000001010101
1110101110101111101111111010101
1000100010101000001000001010101
1011111010101011111011101010101
1010001000101000001000100010001
1010111011101111101110111111101
1010000010001010001010000000101
1010111110111010111011111110101
1010001000100010100000000010101
1011101011101110111011111010111
1000101000100000100010000010001
1110101110111011101111111011101
1000100010001000100000001000101
1011111011101110111111101111101
1010000000101000000000001000001
1010111111101111111011111011101
1010100010001000100010000010101
1011101010111010111110111110101
1000001010100010000010001000101
1011111010101011111010101011101
1010000010101000001010101000101
1010111110111111101011101010101
1010000000000000001000001010001
1111111111111111111111111111111
