1111111111111111111111111111111
1010000000000000100000001000001
1011111111111010111011101010101
1000000010000010001010101010101
1111111010111111101010101010111
1000001010101000101010100010001
1011111010101010101010111111101
1010000010100010101000001000001
1010111110101110101111111011101
1010101000100010100000001010001
1010101010111010111111101010111
1000100010100010000000100010101
1011101110111111101110111110101
1000100010100000100010001010001
1110101110101110111010101011101
1010101000100010001010100010101
1010111011111011101110111010101
1000100010000010100000100000101
1011101111101110111011111111101
1000001000101000000010000000101
1111111010101011111110111110101
1000000010001000100010001010001
1011111111111110111011101011111
1000100000001010000000101000101
1010101111101010111111101010101
1010001010001000100000001010001
1011111010111111101111111011101
1000000010000000101000001000101
1111111011111110101011101110101
1000000000000010000010000000101
1111111111111111111111111111111
