1111111111111111111111111111111
1010001000001000000010000000001
1010111011101011111010101111101
1010000000100010000010101000001
1011111111111110111110101111111
1000000000000010000000100010001
1111111111111011111011111010101
1000000010001000001000100010101
1010111010111111101110101110101
1010100010000000101000100000101
1110101111111011101011111011101
1000100000000010001010001000101
1010111111111110111110101110101
1010100000000000100000101010101
1011101111111111101111101010101
1000100000100000001000001000101
1010111110101111111011111011101
1010000010001000000010000000101
1111101111111011111111111110101
1000100000100010000000000010101
1010111110101111111011111010101
1010000000100000000010000010101
1010111110111111111110111111101
1010100010001000001000100000001
1011101010111010101011101111101
1000001010100010101000100000101
1011111011101110101110111110111
1000101000101010100010000010001
1110101110101010111111111011101
1000000010000010000000000000001
1111111111111111111111111111111
