1111111111111111111111111111111111111111111111111
1000001000000000000000001000000000001000001000001
1111101011111111101111101011111110101110101111101
1000101000001010001000101010000010100000100000001
1010101111101010101010111010111010111111111111101
1010101000000010101010001010100010000000100000101
1011101110111110111011101010111011101110101111101
1000100010001000100010100010001000100010100010001
1110111011101010101110111111101110111110101010111
1000101010001010100000100010001010000000101000001
1010101011101010111110101010111011111111101111111
1010001000101010100000101010001000000000100010001
1011111110111011101111101011101111101011111010101
1010000010001010001000001000100000101000000010101
1010111011101010111110111111111110111111111110101
1010100010001010000000100000000000100000000000101
1010101110111011111110101111111110101111111110101
1010100010100000100010101000000000100000100010101
1010111010101111101010101111111011111110101011101
1000101000101000001010100010001010001000101000101
1011101111101011111010111010101110101011101110101
1000001010001000001000100010100000100000101000101
1111101010101111101111101110111111111111101011101
1000101000100000101000001000100010000000101010001
1011101011111010101011111011101110111110101011101
1010001010001010101000100010001000100000001000101
1010111011101010101110101111101011101111111110101
1010100000101010101010001000001000101000000010001
1010111110101011101011111011111010111011111011111
1010000010101000100010000010001010100010001010001
1011111010101110111011101110101110101110101010101
1000001010000010000000001000100010001000101000101
1011101011111111111111101011111010111110101111101
1000101010000000000000101000100010000000101000001
1111101010111111111110111110101111111111111011101
1000001000100000001010000000100000000000000010001
1011101111101011101011111111111111111111111110111
1010001000001000101000001000000000100000100000101
1010111011111110101011101011101111101011101111101
1010100010100000101010001010101000001000001010001
1011101110101111101011111010101011111111111010101
1010000000101000100010000010100010001000000000101
1010111111101010111110111110111110101110111111101
1010001000001010000010001000000000100010100000001
1011101011101011111011101110111111111010101111101
1000101000101010100000100010100010001010100010001
1010101110111010101111111010101010101011111010111
1010000010000000100000000000101000100000000010001
1111111111111111111111111111111111111111111111111
