1111111111111111111111111111111111111111111111111
1000100010000010000000100000000000100000001000001
1110111010101011111011101110111110101111101011101
1010001000101000001000101000100010001000001010001
1011101111101111101010101011101011111011111010111
1000100000001000101010001000101000001000100010001
1010111111111011101011111110111011111110101111101
1010001000000000101010000000100010000010101000001
1011101011111110101010111111101010111010101111101
1000101000100010001010101000001010101000100000101
1110101110101011111110101011101110101111111010101
1000101000101010000010100000100010100000001010101
1011101011101011101010111110111010101111101110101
1000100010001010001010000010101000100000100010101
1110111110101010111011111010101111111110111010111
1000100000101010101010000010100000000000100010001
1011101111101010101010111110101011111111101111101
1010000000101000100010100000101010000000100000001
1011101111101111111010101111111011111011111111101
1000101000001000001010100010000010000010000000001
1110101011111011101010111010101110111010111111111
1000101000000010101000101010100010001010001000001
1011101111111010101111101010111010101111101010111
1000100010001000101010000010001010100000001010001
1110101110101111101010111110111010111111111111101
1000101000100000101000100000100010001000000000101
1011111011111110101011111111101111101011101110101
1000001000100010101010000010001000101000100010001
1111101010101010101011101010111010101111111011101
1010001010101010001000001000100010100000001000101
1010111110101011111111111111101011111111101010101
1010000000101000000000100000001010000010001010101
1011111111101111101111101110111110111010111110101
1000000010101000100000101010000000100010100000101
1011101010101010111110101011111111101010101111101
1010101000100010001000100010000010001010001010001
1010101111111110111010111011111010111011111010111
1010100000000010100010001000000010101000000010001
1010111111111010101111101111111010101111111011101
1010000000100010100010000000001010100000001000101
1010101111101110111011111011111010111110101110101
1010101000100000101000001010000010000010100000101
1010101010111111101111101110111111111011111111101
1010100010001000000000100010100000101000000010001
1011111110101010111110111010111010101111111010111
1000000000101010100000100010001010000010001000101
1111111111101110101111101111101011111011101111101
1000000000000000100000100000000010000000000000001
1111111111111111111111111111111111111111111111111
