1111111111111111111111111111111111111111111111111
1000000000100010000010000000100000001000000000001
1111111110101010111110101110101111101011111111101
1000000010001010000000101010001000001000100000101
1111101111111011111011101011111011111110101011101
1000100000001000001010001000000010000000001010001
1010101111101111101010111110111111111111111010111
1010101000001010001010000010000010000010100010001
1010111011101010111111111011111010111010101111101
1010001010000010100000000010001000101010001010001
1011101010111110111011111110111111101011101010111
1000100010001000100010000010000000001000101010001
1010111110111011101110101110101111101110101011101
1010100000100010001000101000101000000010101000101
1110101111101110111010111011101011111110101010101
1000100010100000100010100010001010000000100010101
1011111010111111101111101110111110111111111011101
1010001000100000101000001010000010100000001010001
1010101110101110101011111011111010111011101010101
1010100010100010100000100000100010001000101010101
1011101110101010111110101111101011101110101110101
1000100010101010000010001000001000101000100010101
1110101010111011111011101011111110101011111010111
1000101010000010001010001000100000101000001010001
1011101011111110111011111010111011101111101011101
1010001000001000001010001010001010101000101010001
1011111010101111101010101011101010101010101010101
1000001010100010001000101010001010101010001000101
1111101010111010111111101110111010101011111111101
1000001010001010000010101000101000100010000000101
1011111111101011101010101011101011111110111110101
1000100000001000001010101010100010000010001000101
1010111011111111111010101010101110101111101011101
1010100010000010001000100010000010100000101010001
1110101110111010101011111110111110111110101010111
1000100010101000100010001000100010100010001010001
1011111010101111111110101011101010101011111011101
1010000010001000000010100000101000101000100010001
1011101111101011101110111111101111111010101110111
1000101000100010001000001000100000001010100000101
1010101010111111111011111010111111101010111111101
1010100010100000000000100010000000101010000010001
1110101110101111111111101110111110101010111011101
1000100010101000000000000010100000101010001010001
1011111010101011111111111110101111101111101010101
1000001010001000100010001000101000101000001010101
1011101111111110101011101011111010101011111010101
1000100000000000001000001000000010000010000000101
1111111111111111111111111111111111111111111111111
