1111111111111111111111111111111
1010000000100000000000100000001
1011101110111111111010101111101
1010001010100000001010101000101
1010111010101111101010111010101
1010001000101000000010000010001
1011101011101111111111111111101
1000001000101000101000000010001
1111111110101010101011101110111
1010000010100010100010001000101
1010101010111110111110111011101
1000101010100010001000100010001
1011101110101011101011101111101
1000100000101000101000100000001
1110111111101110101110111111101
1010000010001000100010000000101
1011111011101110111011101011101
1000001000100010100010001010001
1011101110101010101110111010111
1010101010101010001000001010001
1010101010111011111011101111101
1010000010001010001000100000001
1011111011101011101110111111111
1000100010101010000010100000001
1010111010101010111010111011101
1010001000100010001010001000101
1111101011111110101111101110111
1000001010000010100000100010001
1011111110111010111011111011101
1000000000001000001000000000001
1111111111111111111111111111111
