1111111111111111111111111111111111111111111111111
1010100000000010000000000010001000000010000000001
1010101110111010111011111010101110111010111111101
1010000010100010001000001000100000100010001000001
1010111110101111101111101111111111101111111011101
1010100000101010001010001000000000100010000010001
1011101111101010111010111110101111111010111110111
1000100010101000000010000010101000001000100010001
1110111010101111101111101011101010111111101011101
1010000010100010001000101000100010000000101000101
1011111110111010111010111110111111101010111110101
1010000000100010001010000000100000101010001000101
1010101111101111111011111111101110101011101010101
1000101000100000000010000010000010101010101010101
1011101010111111111110101110111010111010101011101
1010101010000000001000100000101010000010001010001
1010101011111011101111111110101011111110111010111
1000100000100010100000000010001000100010001010101
1011111110101110111111111011101110111011101010101
1010000010101000001000100010101000100010001010101
1010111011101011111010101110101011101010111010101
1010001000001010000010101000001010001010100010001
1011101111111010111110101011111010111010101011101
1010100010000000100010001010000010101010001010101
1010111011111110111011111110111110101011111010101
1000001000000010000000000000100000100010000000101
1011111111111011111111111111101011111110111111101
1010000000001010001000000010101000000000100000001
1010111111101010111011101010101111111111101111111
1010100000100010000010001000100000000000100000101
1010111110111111111110111110101111111110111110101
1010000010000000000010100000101000100000000010101
1011111010101111111010111111101010111111111110101
1010001010100010001000100000001010000000000000101
1010111011111010101111101111111011111111111111101
1010001000001000100000000000001000000010000000001
1011101111101111111111111111111111111010101111101
1000000010100000000010000000000000001010101000001
1111111010111111111010111111101111111011101011111
1000001000100000100010100000100010001000101000101
1011101110101110101010101011111010101110101110101
1000100010001000101010101010001000100010001010101
1110111011111011101010111010101111111011111010101
1010001010000010101010001000100000101000100000101
1011101010111110101111101111101110101110101111101
1000101010001000101000100010001010001000100000001
1011101011101010101010111010111011101011111111101
1000001000000010100010000000100000001000000000001
1111111111111111111111111111111111111111111111111
