1111111111111111111111111111111
1010000000000010100010000000001
1011111111101010101010111011101
1000001000001000101010001010001
1111101011111011101010111010111
1010001000100010001000100010001
1010111010111010111111101111101
1010001010001010000000101010001
1011101110101110111111101010111
1000100010100000100000101010101
1010111011111111101110101010101
1010001010000000001010101010101
1011101010111111111010101010101
1000101000100000000010001010001
1110111111101111111011111011101
1000100000101000001010000000001
1011101010101111101010111111111
1000001010100010001000100000001
1011111011111010111111101011111
1000101010000010000000101000001
1110101010111110101110111110101
1000101010000010100010000010101
1011101011111011111011111011101
1000001000001000100010001010001
1110111110101110101110101010101
1000100010101000100010101000101
1111101011101011111010101111101
1000001000001010000010100000001
1011111111111011101110111111111
1000000000000000001000000000001
1111111111111111111111111111111
