1111111111111111111111111111111
1010000000000000100000000000101
1011101111101111101111111010101
1000100010001000101000100010001
1110111010111010101110101111101
1000100010000010100010100000101
1011101111111110111010111110111
1000101000100000100000000010001
1110101010101011101111111111101
1000101010101010001000000000001
1011111010101110111011111111101
1010000010101000101000100000001
1010111110101011101110101111111
1000100000100010001010101000001
1111101111101110101010111011101
1000101000001000100010000010101
1010101111101011111011111010101
1010100000101010000010001000101
1011111110101010111110101110101
1000000010100010100000100010101
1011111010111011101111111011101
1010100010001010001010001010001
1010101011101110111010101010111
1010101010001000100000100010001
1010101110111011101111111110101
1000100010001000101000000000101
1110111011101110101111111111101
1010101000101000100010001000101
1010101110101011111010101010101
1000000010000010000000100010001
1111111111111111111111111111111
