1111111111111111111111111111111111111111111111111
1000000010001000000000000010000000000010000000001
1111111010101111111011111011111011111010101111111
1000001000100000001000100010001010100010100000001
1011111111111111101010101110101010101111111111101
1000000000100010001010100000101010100010000000001
1111111110101010111110111111101010111010111111101
1000000000101000100000100010001010001000100010001
1011111110101111111011101110111010101111101010111
1000100000100010000010001000100010101000001010001
1010111111111010111110101011101110101010111111101
1010001000000010001000101000001010100010000000101
1011101011111110101011101111111010111111111011101
1010100010001010101000100010001000100010000010001
1010111110101010101110111010111011101010111010111
1000001000100010100010100000100000101010100010001
1111101010111110111010111011101111101010101111101
1000101010000000100010001010001000101000101000101
1010101111101111101110101110111010101111101011101
1010001000101000001000101000100010100010001010001
1011111010111011111011101011101110101011101010111
1000000010001000001000100010101000101000100010101
1111111111101111101111101110101011101110111110101
1010000000100000100000100000101010000010000000101
1010111110111110101110111111101011111011111111101
1010101000100010100010100000001000001010001000001
1010101010101010111010101111111111101010101110101
1000101010101010001010001000100000001010100000101
1011101010111011101011111010101111111010111111101
1000101010001000101000100010101000001010000000101
1110101011101010101110111110101010111010111110101
1000101000100010100010100000101010000010101000101
1011101110111111111010101110101110111110101011101
1000101000100000100010001000100010001000001000101
1110101011101110101111111111111011101111111010101
1000101000001000101000001000000010101000001010101
1011101111111011101010101011111110101011101110111
1010000010000010001010100010000010100010100010001
1010111010111010111110111110111010111110111011101
1000101010001010001000100000001000000010000010001
1111101011101111101011101111101111101110111110111
1000001010100000101000100000100010001000100000001
1010111010111110101110111110111011111011111110101
1010000010000010101000100010100010001000000010101
1011111110111010101011101010101010101111111010101
1010000010101010101000101010101010100010000010101
1011101010101010101110101110101110101110111111101
1000001000100010000000100000100000100000000000001
1111111111111111111111111111111111111111111111111
