1111111111111111111111111111111111111111111111111
1010000000001010000010000000001000000010100000001
1011101111101010101011101111101111101010101011111
1010001000000010101000100000100000101010001000001
1010111011111110101110111110111110101010111111101
1010001000100000101010000010001010001010001000001
1010101111101111101011111011101011111011111011101
1010100010000010001000001000001000001000000010001
1011111010111110111011101111111010111111111110111
1000001000100010101010100000001010000000000010001
1111101110101010101010111110111011111110111011101
1000100010101000100000000010000010000010001000101
1011111010101111111110111110111111111011101011101
1010000010100000100010100010001000001000101010001
1010111111111110101010101011101011101010101110111
1010000000000010001010101010100010100010100000001
1011111111111010111011101010111110111011111111101
1000001000000010001010001010000000001010000010001
1011101011111111101010111011101011111010111011111
1010001000100000101000100010001010000010100010001
1010101110101011101111101110111110111110101110101
1010100010101010001010001000000000100000100000101
1110111010101010111010111011111111101111111111101
1000100010101010100010101000100000100010000000001
1011101110111010101010101110101011111010111111101
1000100010100010101010100000101010000010100010001
1010101110101110101010101111111010111110101011111
1010101000100000101010100000100010001010101000001
1010101011101111111010111110101011101010101111101
1010101010001000000010100000001000101010100010001
1010111010111010111010111111111011101010111010101
1010000010100010100010000010000010001010001010101
1011111110111110111011111011111110111011101010111
1000001000000010001010001000000010100000100010001
1111101111111011101011101111111010111011111111101
1000100000001000001000100000001010100010000010001
1010111111101111111110111011101010101110111010111
1010000010001000000010100010001000001000101010001
1010111110111011111010101110111111101011101010101
1010100000100010000010001000100000101000101010101
1011101111101110111110111111101110111110101010101
1000101000100010100010100010001010100000100010101
1110101010111110101010101010111010101111101111101
1000101010000010001000101010001010001000100000101
1011101011111011111111101011101011111011111110101
1000101010001010000000001000001000001000000010001
1010101010101010111111111111111011101010111111101
1010000010100000100000000000000000100010000000001
1111111111111111111111111111111111111111111111111
