1111111111111111111111111111111111111111111111111
1010000000000000100000000000001000000000100000001
1011111011111110101011111111101011101111101011101
1000001000001010101000001000001000100000001010101
1111101111101010101111101111111110111111111010101
1000100000101010101000100000000000100000001010001
1010111110101010101110111111111111101111111010111
1010100010001000100000001000000010001000000010101
1011101011111011111111101011101011101011111110101
1000001000001000000000101010001000001000100000001
1011111111101111111110101110111111101110111111101
1010000000100000100000100000100000101010000000101
1010111110111110101111101111111110101011111110111
1000101000101000100010001000000010001000000010001
1111101011101010111011101011111010111111101111101
1010001000001010001000101000100010000000001000101
1010101111101011101110101110101111111110111010101
1010100000101010000010101000100000100000100010101
1010101110101011111010111011111110101111101110101
1000100010101000001010001000101000100010001000001
1011111011101111101111101110101011111010111111101
1000101000000000100010001000101000001010000000101
1110101111111011111010111011101111101111111110101
1000100010001010000010001010001000100000000000101
1011111010101110111011101010101011111111111111101
1010001010100010001000100010101000000000100000001
1010101010111011101110111110101111111010101111111
1000100010001000101000100000100000100010100010001
1110111111101110101110111011111110101110111011101
1000100000001010100010000010000010001010101000101
1111101111111010111011111110111111111010101110101
1000001000001000000010000000000000000000100010001
1011101011101011111111111111101111111011111011101
1010001010001000100000000000101000001010001010001
1011111010111111101111111110101011101010101010111
1000000010000010001000000010101010001000100010101
1011111111111010111111111010111010111111111110101
1000100000001000100000000010000010000010000000101
1110101011111111101111111011111111111010111111101
1000101010000000001000000010000000001000100000001
1011101110111110111011111110111011111111111110101
1010000000000010001000001000001000000010000010101
1011101111111111101111101011111111101010111011101
1000100010000000101000101000100000001000101000001
1110111110111110101110101111101111111111101111101
1010100010001010101000100010001000100000000000101
1010101011101010101011111010111011101111111011101
1000001000001000001000000000100000000000001000001
1111111111111111111111111111111111111111111111111
