1111111111111111111111111111111
1010100000000000100000100010001
1010101111101110101110101011101
1010001010001010100010001000001
1010111010111010101011111111101
1010000010001000101000001000101
1011111011101011111111101010111
1000100000101010000000100010001
1110111011101011101110101111101
1010001010001000100010101000101
1011101010111110111010111010101
1010001010001010000010000010101
1010111110101011111111111110101
1010000010101000100010001000101
1011111011101010101010101011101
1000100010001010001010101000001
1010101110111011111011101111101
1010100010100010001000000000101
1010111010101110101110111111101
1010100010100010100000100000101
1011101110101010111111101110101
1000001000101010000010001010001
1011111011101011111010111011111
1000100000101010001010100000001
1110111110101010101010111011101
1010100010101000101010100010101
1010101010101111101110101110101
1000101000100000100010101000101
1011101111111110111010101011101
1000001000000000001000001000001
1111111111111111111111111111111
