1111111111111111111111111111111111111111111111111
1010000010000000000000000010000000000010000000001
1011101110111111101111111110101011111110101111101
1000100010100000100000000010101010000000100010001
1110111010111011111111111010101110111111111010111
1010100010001000000000101000100000000000100010001
1010101011101111101010101111111111111110101111101
1000101010001000101010001000100000100010100010001
1011101110111010101011101011101110101011111010111
1010000010001010101010000010001010001000100010101
1010111011101010111011111010111011111110101110101
1010001000101010001000100010001000001000100010101
1011111110101011101110101111101011111011111010101
1010000010100010001000100000101000100010000010001
1010111010111110111011111110101010101110111111101
1000100010000010100010001000101010101000101000001
1111101111101010111010101111101110101110101011111
1000101000101000100010101000100010100000101010001
1010101010111011101110101010111010111111101010111
1010001010001010001000100010001010000000001010001
1011111011101010111011111111101010111110111011101
1000000010001010001000000000100010100010001010001
1111111110111011101111101110111110101111101010101
1000100010100010001000101010000010101000001010101
1010101010101110111010101011111010101011111010101
1010001010100000100010100000001010101000001010101
1011111010111110101110111111111010101111101010101
1010001000100000101000100010000010100000101010101
1010101111101111101011101010111110101110101010101
1010100000101000101010001010100000100010100010101
1010111010111010101011101010101111111110111110111
1010001010000010001010001000101000000010000000001
1011101011111111111010111111101110111010111111101
1000101000100010001010100000100000101010100000101
1110101110101011101010101110111111101010111011101
1000101000101000100000101010000010001010000010001
1011101010101110111110101011111010111011111110101
1010101010101010100010100000100010000000001000101
1010101011101010101011111011101111111111101011101
1010001000001010001000000010001000001010001000101
1010111111111011111111101110111011101010111010111
1010000000100000100000100010000000101000100010001
1011111110101011101110111011111111101011101111101
1000100010001010001010100010000000001010000010001
1110101010111110111010101110111111111011111110111
1010001010100010001010101000100000001010000010001
1011111011101011101010111011101011111010111011101
1000000000001000001000000010001000000000100000001
1111111111111111111111111111111111111111111111111
