1111111111111111111111111111111
1010000010000000000000100000001
1010101010111111111110101111101
1010101010100000000010001000001
1011101010101111111011111011111
1000101010000000001000101000101
1110101011111111101110101110101
1000101000000010101000101000101
1011101111111010101011101011101
1010100010100010101010000000001
1010101010101110101011111111111
1010101010000010001000100010001
1010101011111010111110101010101
1010001000001010100010001000101
1011111111101011101011111110101
1010000010001000001000000010101
1010111010111111111111111011101
1000101000101000000000001000101
1111101111101011101111111110101
1000001000001000100000000010001
1011101010111110111111111011101
1010000010100010001000001000101
1011111011101011101111101011101
1000001010001000100010001000001
1111101010111110111010101111111
1000101010001010001010101000001
1010101111101011101010101011101
1010001000101000101010101010001
1011111010101010101010101110101
1000000010000010100000100000101
1111111111111111111111111111111
