1111111111111111111111111111111
1010000000100000100000000010001
1011101110111010101111111010111
1000001010001010001000001010001
1111111011101011111011101010101
1010001000101000100000101010101
1010101010101110111111101011101
1010101010001000100000100000101
1010101011111011101110111110101
1010100010000000000010000010001
1010111111111111111110111011101
1010100000000000000010001010001
1010101111111111111011101011111
1010100010100000001010001000001
1010111010101111101010111111101
1010000010101000101010000000101
1011111110101011101011101111101
1000000010000010001010101000101
1011111011111110111010101010101
1010001000000000100010001010101
1010101111111110101110111010101
1000100010001000100010001010101
1011111011101011111010111010101
1010001000100010001010100010101
1011101110111110101010101110101
1000000010100010100010101000101
1111111110101010111110101011101
1000000000101000100010101000101
1011111111101111101011101110101
1000000000000000001000001000001
1111111111111111111111111111111
