1111111111111111111111111111111111111111111111111
1000100000000010000000000010001000001000100000101
1110111111101010111011111010101010101010111010101
1010100000001010100010001000101010101010000010101
1010101111111010101110101110111010101011111110101
1000100010000010101000100010100010100010000010001
1011101011111011101011111010101110111011111011101
1010001000001000100000001010101010001010001000001
1011111011101110111111101011101011101110101111101
1000001010001010000010101010000000100010100000101
1111101110111011111010101010111111101010111110101
1000100010100000101010101000100000101000001000101
1010111010101110101010101111101110111110111011101
1010001000100010001010101010001010100010100010001
1011111111101011111010101010111010101011101011111
1000100000001010000010100010001000001000101010001
1110101111111010111110111011101111111110101110101
1000100010000010100010000000100000100010100000101
1010111010111010101010111111111110101010111111101
1010001010001010101010001000000010101010000000101
1011111011101110101011101011111010101111111110101
1000100010001000101010001010001000101000000010101
1010101110111011101010111011101111101010111110101
1010100010000010001010101000100000100010000000101
1010111011111110111110101110111110101111111111101
1010001000001000000010000010100000100000000010001
1110101111101011111011111010101111111111111010111
1000100000101010001000000010100000001000100010001
1011111110101110101111111110111111101010101110101
1010000010101000100000000010001000100010101000101
1011101110101011111111111011101010101110101011101
1000101000101010000010001000100010100010101000101
1010101011101010111010101110111110111110101110101
1010100000100010101010100010001000100010100010101
1010111111111110101010111011101011101010111011101
1010000000100000001000001000101000001010100010001
1011111110101111111111111110101011111010101110111
1010000010001000100000100000101010000010101000001
1010111011111010101110101110101010111110101011101
1010001000101010100010001000101010100010001010001
1011101110101010111010111111101010101110111110101
1000001000001010000010100000001010101000100000101
1111111111111010111111101111111110101011101111111
1000000000000010100000001000000000101010000000001
1011111111101111101111111111101111101011111110101
1010000010001000001000000010001010000010000010101
1010111011111011111011111010111010111110111011101
1000001000000000000010000000100000000000100000001
1111111111111111111111111111111111111111111111111
