1111111111111111111111111111111111111111111111111
1010000010001000001010000000000010000000001000001
1010101010101110101010111111101110101110111011101
1010101000101000100010001000100000100010100000101
1011101111101011111011101110111111111011101111101
1000100010101000001000100000100000001000001000001
1110101010101111101111111110101111101111111011101
1010101010001000100000000000101010001000001000101
1010101010111010111110111111101010111011101010111
1000101010000010000010000010101010001010001010001
1011111011111111111011111010101011101010111111101
1000001010001010001000100010101000000010001000001
1111101010101010101110101110101111111111101011101
1000001010101010100010100000101000001010001010101
1011111010101010111010111110101011101010111010101
1010001000101000100010001010101010001000100010001
1010111011101011101111101010101010111011101011111
1010000000101010100000001000100010101000101000001
1010111111101010111111111011111110101110101111101
1010001000001000001000000000100000101000101000001
1011111011111111101111111111101111101011111011101
1000100010000000100000000000001000001000100010101
1110101110111011111111111111111010111110101110101
1010001000001000001000001000000010000010001010001
1011111111101110101110101111101111101011111010111
1000000000101000100000100000100000101000000010101
1010111110111011111111111110111111101011111010101
1010100000001010000010000010000000001010001010101
1010111111101010111010111011111011111010101110101
1010000000100010001010101010000010001010100000101
1011111110111111101010101010111110101110111111101
1000100000100000101010101000100010100000101000001
1110101111111010111010101111101010111111101011101
1010100010000010000010100010001000100000000000101
1010111010111111101110101110111111111111111110101
1010001010100000101000100010000010000000001000101
1011101010101110111011111011111011101111101111101
1000101010000010001000100000001000001000100000101
1011101011111111101110101111101111111010111110101
1000001000000000101000100010001000001010000010101
1011111111111110101011111010111010101110111110101
1000001000000010101010000010001010101000100000101
1111101011111010101011101111101010101010101111101
1000101010000010101000001000001010100010101000001
1011101010111110101011111111101010111111101010101
1000100010001010100010001000101010000010001010101
1010111111101010111110101010111011111010111110101
1010000000000010000000100010000000001000000000101
1111111111111111111111111111111111111111111111111
