1111111111111111111111111111111111111111111111111
1000001000001000000000000000001000100000000000101
1111101011111011111111111111101010101111111010101
1000001010000000000000000000101010001000001010001
1011111010111111111111111111101011111011101011111
1000001000100000000000000000101000001010001000001
1111101011101111111111111110101111101010101111101
1000101010100010000000100010101000001010101000001
1011101010111010111110111010101011111010111011101
1000101000001010000010100010100010001010100010001
1010101111111010111110101110101110101010101110111
1010100010001000100000101000101000101010100010001
1010111010101111101111101011101011101010111011101
1010001000100000001000001010101000100010001010001
1011101111111111111011111010101011111010111010111
1010100000000010000010000010101010001010100010001
1010101111111110111010111110101110101110101111101
1010100000100010101010000010000000100010101000001
1010111110101010101011111010111111111010101110111
1010100010001000101000001010100000001000100010001
1010101011111111101111101010101111101110111011101
1010001000001000000010001010101010001010001000101
1010111110101011111110101011101010111011101110101
1010001000100010000000101000001010001000000010101
1011111011111110111111111111111011101111111010101
1010000010000000100000100000001000100000100010101
1010111010111011101110101111101010111110111110101
1000101010001010001000101010001010001000100000101
1111101011101110111011101010111011101011101111111
1000001000100000101000001010000010100010000000001
1011101110111111101111111011111110111110111111101
1010100000100000100000001010000000100000100000001
1010111111101011101110101010111010101111101111101
1000001000001000100010101000100010101000101000001
1111101111111010111010101111101110101110101111101
1000100000001010000010100000001010100000100000101
1010111111101111111110111111111010111110111110111
1010000000001000000000100010000010001000000010001
1011111111111011111111101010111011101111111110101
1010000000000010000000001010001000100000000010101
1011111110111110111111111011101110111111111011101
1000000010001000100000100000001000100000001000001
1111111011101011101110111111111111101011101111101
1000001000001000001010000000000010001000100010001
1011101111111011111011111111111010111110111110111
1010101000001010000000000000101000100010000010101
1010101011101011111110111110101111101011111010101
1000100000100000000000100000000000001000001000001
1111111111111111111111111111111111111111111111111
