1111111111111111111111111111111111111111111111111
1010000000100010000000000000100000001000000000001
1010111110101010111111111010101110111011111111101
1010001000001010100010001010101010001010001000101
1010101111111010101010101011101011101010101010101
1010100010000010001010101010001010001010101010001
1010111010111111111110101010111010111010111011101
1010001010000000000010101010000010000000100010001
1010111011111111111010101011111011111111101110111
1010100010000000001000101000100000100000101010101
1010101111111011111111101110101111101110101010101
1010100000100010000000100010101010001000001010101
1011111110101110101110111010101010111111111010101
1000100000101000100010001010000010000000100000101
1110101111101011111011111011111111101110101111101
1010001000100010001000100010000000101000101000101
1011111010111110101010101110111110111011101010101
1000000010000000101010100010100000100010101010001
1011111010111111101110111010111110101110101011111
1010001010100010001000001010000010001010001000001
1010111011101010111010111010111011111010111011101
1000100010001010000010100010001000100010100000101
1111101110111011111111101111101110101010111110101
1000100010001010000000101000000010101010000010101
1010111011101010111110101011111110101011111011101
1010001000101000101000101000100010101000000000001
1011101110101111101011101111101010111111111111101
1000100000101000001000100000001010001000001000101
1010111110101111101110111111111010101011101010101
1010001000101000101000000010000010100010001010001
1011101011101010101011111010111111111010111011111
1000101010000010001000101010000010001010001000101
1011101110111111111110101011111010101011101110101
1010001000101000100010100010001000101010101000101
1010111011101010101010101111101111101010101110101
1010000010001010001000100000100000101000100010101
1111111010111011111111111110101110101111111010101
1000001000100010000000100010101000100010001010001
1011101111101110111111101010111011111010101011101
1010001000100010100000001000000010000010101000101
1010111010111010101111111111111110111110101010111
1010100010100010100000100000000000100000101010001
1010111010101110101111101111111111101111101111101
1010000010001000001000101000001000000010100000001
1011111111111011111010101011101111111010111111101
1010001000001000001010001010100010000010000010001
1010101011101111111011111010111010111110101110111
1000100000100000000000000010000000100000100000001
1111111111111111111111111111111111111111111111111
