1111111111111111111111111111111111111111111111111
1000100000100010001000100000000000100000000000101
1110101110101010101010101111101110111110111110101
1000101000101000101010100010101010100000100010101
1011101110101111101110111010101010101111101010101
1010100010001000001000100000101010001000001010001
1010101011111110111011101111101011111011111111101
1010001000000010001010001000001000100000000000001
1011101111111011101010111011111011101111111111111
1000100000001010101010001010000000000000000000101
1110111111111010101011101011111111111111111110101
1000100000001010101000101000100000000000000010001
1011101111101010101010101110101111111111111011111
1010001000000010101010000010001010001000001000001
1010111111111110101011111111101010101011101011101
1010000010001000101010000000100010101010001010001
1011111010101010101110111110111110101011101110101
1000100010101010100000100010100000101000100010101
1110101110101010111111101010101111101010111010101
1010100000101010000010001000100010001010001000101
1010111110101111111010111111111010111111101111101
1000100010100010001010001000000010100000101000101
1011101011111010101011101110111110111010101010101
1010001000000010100010001000101000100010100010101
1010111111111110111110111011101011101110101110111
1000100010000000100010100010001000001000100010001
1111101110111011101010111010111111111011101111101
1010000000101010001000100010100010001010001000001
1010111111101010111111101110101010101010111011101
1010000000001000100000001000101000100010101000101
1011111111101111111110111011101111111110101110101
1000000000101000000000100000101010000000001000101
1011111011101011101111101110101010111111111011101
1010001000001010001000100010001000001000000010101
1010101111111010111110111011111111111011111110101
1000101000001010000010000010000010001000001000001
1111101010101111111011101110111010101111101011111
1000001010100000001000100000101010100000101010001
1011111110111111101010111111101010111110101010101
1000000000100000101010101000001010100010101000101
1111111111101011101110101010111010101010101111101
1010000000101000100000101010000010001010100010001
1010111110101110111111101011111111111010111011111
1010001010001010100000100010000000100010001000001
1011101011111010101010101110111110101111101011101
1000100010000010001010101000100010001000101000101
1011111010111011111011101110101011111010101111101
1000000000100000001000000000101000000010000000001
1111111111111111111111111111111111111111111111111
