1111111111111111111111111111111111111111111111111
1010000000101000000000100000000000100000100000001
1010111010101011101110111111101110101011101110111
1010001010001010100010000000001000101000100010001
1011101011101010111010111111111111101110111011101
1010001010001000001010100000001000001010000010001
1011101011111111101010101111101011111011111010111
1000101000000010001010100010101010000010001010001
1110111110111010111011111010101011101110101111101
1010100010001010001000001010100010001000100000101
1010101011101011101110111010111110101011111110101
1010001010101000001000100000001000101000101000101
1011111010101111111011101111101010111110101011101
1000100010101000100010001000100010100000100010001
1010101110101010101110111010111011101111101111101
1010101000000010100000100010100010001010001000001
1011101011111111111111101110111110111010111011101
1010001010000000100000001000100010100010001010101
1010111010111110101111111011101010111011101010101
1010001010001000101000100010001010100000100010101
1011101011101011101010101110111010101110111110101
1000101010001000101010101000001010100010100000001
1010101110111110101110101110101010101010101111111
1010101000100010101000100010101010101010100010001
1010101011111010101010111011101010101011111010101
1010100010000010001010001000001000101000000010101
1011111111101011111011101111111111101111111110101
1000000010001000101000100000001000100010000010101
1011101010111110101010111111101010111010111010101
1000101010001000100010001000000010001010100010101
1011101010101011111111101111111011111010101110101
1010001010101010000000101000001010001010100000101
1010111011101011101110101011101110101010111111101
1010100000001000001010101000100000100010100000001
1010111111111111111010101110111111111110111111111
1010000000000010000000100010100000001000000000001
1011111111111010111110101110111110111011111111101
1010001000001010100010001000100010001000100010001
1010101011101011101010111011101011101110111010111
1000101000101000101010100010001000100000000010001
1111101110101110101011101110101110111111111011101
1000100010100010101000101000100010000010001000101
1010111010111010101110101011111011111010101011101
1010001000101010001010001010001000100010100010001
1011101111101011111011111010101110101111111110101
1010100010001010000010000000101000100010000000101
1010101110101011101011111111111011111010111111101
1000100000100000001000000000000010000000100000001
1111111111111111111111111111111111111111111111111
