1111111111111111111111111111111111111111111111111
1000001000000000001000001000100000100000100000001
1111101011111011101111101010101110101011101111101
1000101000001000100000100010001010001000001010001
1010101110111110111110101111111011111111111010111
1010001000100000100010101000001000001000001010001
1011111111101111101010101011101110101011101011101
1010000000101000101000101010100000101010100010001
1011101110101011101111101010111111101010111010111
1000001010001000001000100010000000101010001010001
1111111011111011111010111111101110101010111011101
1000001000100010100010000000001010100010100010001
1011101010101110101111101111111010111110101110101
1010001010101010001000100010000000000000101000101
1010111010101010111011111011111111111111101011111
1010001010001000100010001000000000100010001000001
1011101011111011111010101111111110101010111111101
1010101000001000000010100000000010101000001000001
1010101111101011111110111111111010101111111011101
1010100000001010000000100000100010100010000010101
1010111111111110111111101111101110101110111110101
1000000000100000100000100000001000101000100000101
1111111110111011101011101111111110101011111110101
1000100010001000101000000000100000101010000010101
1010101011101010111111111110111011101010111010101
1010101000001010000010000010001000001010101010101
1010101111111110111010111011101110111010101010101
1010100010000010100010101000100010001000101010001
1011111010111010101110101110111011101111101010111
1000001000100010101000100010001000100000001010001
1110101111101110101011101011101110111110111011101
1000101000101000101000101010100010001000100010001
1011101011101011101110101010111011101110101110111
1000101010001010100010001000001010100010101000101
1010101010111010111011111111101010111011101011101
1010100010100000100010000010001010001010001000101
1110111110111110101010111010111011101010111110101
1000100010100010101010100010101000100000100010101
1011101010101010101011101010101110111111111010101
1010001010001010101000001010100010001000000010101
1010111011111010101111111110111011101011111110101
1010001000001010100000000000000000101000000010001
1011101111101011111111101111111111101011111011101
1000101000100010000000101000000000001000100010001
1110101110111110111110101011111111111011101010111
1000101000000010001000101010000010001010001010001
1011101011111011101011111010101110101010111111101
1000000010000000001000000010100000100010000000001
1111111111111111111111111111111111111111111111111
