1111111111111111111111111111111
1000000000001000000010000000001
1111111111101011101011111110101
1000000000101000101000100000101
1011111110101111101110101111101
1010000000100000101010001000001
1110111110111110101011111011111
1000100010100000101000001000001
1011101011101111101011101111101
1010001010001000001000101000101
1010111010111010111110101010101
1000100010001010000010100010001
1011101111101011111010111111111
1000100000101000100010100000001
1110111011101110101110101111111
1000100010001000101010100000001
1011101110111011101010101111101
1010100010101000101010100000101
1010111010101110101010101111101
1000100010100000101000101000101
1111101010111110101110111010101
1000001010100010100010000010001
1011111010101011111011111111101
1000100010101000000010000000001
1110101110101111111110111111111
1000101000100010000010100000001
1011111011111010111010111011101
1010001010001010001010100010001
1010101010101011101010101110111
1000100000100010001000001000001
1111111111111111111111111111111
