1111111111111111111111111111111
1000100000000000100000000000001
1110111011111110111111101111101
1010001000001000000000101000001
1011101111101111111110101011111
1000100000100010000010001000001
1010111110101011111011111111101
1010100000101000100000000010101
1011101111111110101111111010101
1000100010001000100010000000101
1110111010101011111011111111101
1000001000100010001000100000001
1011111111111110101110101111111
1000100000100000101000101000001
1010101010101011101010101110101
1010101010101000100010101000101
1010101011101110111110101011111
1010101000001010001000101000001
1110101111111011101111101011101
1000100010000000101000001000101
1011111011101110101011111111101
1000001000101000101010001000101
1110111110111011101010101010101
1000100010001010001000100010001
1010101011101010111111111111101
1010101000101010000000000000101
1011101110101011111111101011101
1010001000101000100000001010001
1010111011101110101111111110111
1000001000000000100000000000001
1111111111111111111111111111111
