1111111111111111111111111111111
1000000010100000000010100000001
1111111010101011111010101110101
1000001010001010000010000010101
1011101010111011101111111110101
1000101010001000100010000000101
1110101011101110111010111111101
1000101000101010101000101000001
1011111110101010101111101011111
1000000000100010101000000010001
1011111111111110101011111111101
1010000000001000100000001000001
1010111111101011111111101011101
1010100000101000000010101000101
1010101110101011111010101010111
1000100010101010000010101010001
1111111110101110111110101111101
1000000000100000100000101000001
1010111110111111111110101011101
1010100000101000000000100010001
1010111011101011101111111110111
1010001000001010100000000010001
1011101111101010111111111011101
1010101000001010000000001000001
1010101011111011111011101111111
1010101000001000001000101000001
1010101111101111101110101111101
1000101000001000100000100000101
1110101111111010111111111110101
1000100000000010000000000000001
1111111111111111111111111111111
