1111111111111111111111111111111
1010000000000010000000000000001
1010111111111011111111111111101
1000100000001000000010000000001
1111101111101111111010101111101
1000001000100000001010101000101
1011101110101111111010111010101
1010001000101000000010100010101
1110111011101011111110101110101
1000100010001010000000001000101
1011101110111011111110111011101
1010000000101000000010100010101
1011111110101111111011101110101
1000000010001000001010001000101
1111111011101011101010111011101
1000001000101000101000100010001
1011101110111110101111101010111
1010000000100000100000101010101
1011111110101111111010101110101
1000001000100010000010001000101
1011101111111010111111101011101
1000100010001010000000101000101
1111111010101011111110101110101
1000000010100010001000100010001
1011111010111111101011111011101
1010001010100000001000101000101
1010101110111011101110101110101
1010100010001010001000100000101
1010111011101010111011111111101
1000001000000010001000000000001
1111111111111111111111111111111
