1111111111111111111111111111111111111111111111111
1000100000000000101000000000001000001000100000101
1110111011111010101011111011101110101010111010101
1010001010000010100000001010000000101010000010001
1011101110111110101111111011111111101011111111101
1000100010100010100010001000100000001010100000001
1011111010101110101110101110111110111010101111111
1000001000100000101000100010100010001010100000101
1011101111101111111011111010101011101010111110101
1000100000101000000010001000101000100010001000101
1111101111101110101111101011101110111110111011101
1000100000100010101000100010001000100010001010001
1010101110111010111010111110111011101010101010101
1010101000100010000010001000101000101000100010101
1010111010101110111111101011101110111110111110101
1010000010100010100010001000000010000010001000101
1011111111111010101010111111101111111011101011101
1010000000100010101000100000001000100010101010001
1010111110101110101110101111111010101110101010111
1010100010001010101000101000100010001000101010001
1010101111111010101011101110101111111011101111101
1000100000000010101000100010101000001000101000001
1011111011101110101111111010101011111010101011111
1010001000100010101000001010101000001010001000001
1010101110111010101011101010101011101011111011101
1000101010001010100010001010101010100010000000101
1111101011101010111110101010101010111111111111101
1000101000001000001000101010101000100000000000101
1011101011111111111010111010101110101111111110101
1010001010000010001010100000101000001000000000101
1010111011101010101011101111101111111011111111101
1010100000001010101000001000100010000010000000001
1010111111111010101111111010111010111110111111101
1010100010000010101000000010000010100000100000101
1010101011111110101011111111111110111011101110101
1010101010000000101000100000000010000010001010001
1010101010111111101110101010111111111110111011111
1010001010101000100010101010100000000010001000001
1011111010101010111010111011101011111011101110101
1000001000100010000010001000001000001000101000101
1011111111101111111110101011111111101011101011101
1010000000100000000010101010000010101010001010101
1010111110111111111011101011101010101010111010101
1010001000100000101010001000101000101010100010101
1010111011101010101010111110101110101110111010101
1000100010001010001010100010101000100010100010101
1011101110111011111010101010101011111010101110101
1000100000001000000000101000001000001000001000001
1111111111111111111111111111111111111111111111111
