1111111111111111111111111111111
1010000000000000000000001000001
1011111010111111111111101110111
1010001010100010001000100010001
1010101110101010111010111011101
1010100000101010001010001000101
1010111111101010101011101110101
1010001000001010101010000010001
1011101011111011101010111011101
1000001010001000001010001000101
1111111010111111101011101111101
1000000010000000001010100010001
1011111010111111111010111010111
1010001010001000001010001000101
1010101011101111101011101111101
1000101010001000001000100000001
1011111010111011101110111110101
1010000010000010001010000000101
1010111111111110111011111111101
1010000010100000100000001010001
1011111010101111101111101010111
1000100010100010100010001010001
1110101110111010101011101011101
1000101000001010001000101010001
1111101010111011111110101010111
1000001010000000000000100010101
1011111111111111111111111110101
1000000000001000000010000010001
1011111111101011111010111011101
1000000000100000001000001000001
1111111111111111111111111111111
