1111111111111111111111111111111111111111111111111
1010001000100000000000000000001000000000000000101
1010101010111111111110111111101110111111101110101
1000101010000010000010100010000010001000100010101
1111101011111010111010101011111011101011111010101
1000101000100010101010101000001000100010000010101
1010101110101110101010101111101110111110111110101
1010101000101000101010101000101000100010001010001
1010101011101011101010101010101011101011101011101
1010100010100010001010101010101000001000101000101
1010111110111110101010101011101111111110101110101
1010001000100000101010100010001000001010100010001
1011111010101111101010111010111011101010101011111
1010000010100000100010000010001000101000101010001
1010111110111110111110111111101110101011111010101
1010000010001000100010001000000010101000000010101
1011111010111011101011101011111110101111111110101
1000001010000010001010001010000010100000100000101
1011111011111110111010111010111010111110101111101
1010001010000000100010001000100010001010000010001
1010101011101110101111101111101011101011111110101
1000101000100010101000101000101010001000100000101
1011101110111110111010101110101110111010101111101
1010000010000010000010000000100010100010100010001
1010111011111010111111111111111010101110111011101
1010001010001010001000101000000010001010001000101
1111101010111011101010101011111011111011101110111
1000001000100010001010101010000000101000101010001
1010111111101110111010101010111110101010101011101
1010100000001010100010101010100010001010000000101
1011101111111010111010101011101011101011111111101
1010001000100010000010001000101010001010001000001
1010111010101010111111101110101011111011101011101
1010001010001000100000100010101000000000001010101
1011101011111111101110111010101111111111111010101
1010001010001000001000101010001000000010000010001
1010111010111011111011101011111111101110111110111
1000101010001010001010000000000000100010100010001
1011101011101010101011111111111110111010111011101
1000100000001000101000001000000010000010001010001
1110101111111111101111101011111011111011101010111
1000101000000000101000100010001000100010001010001
1011111011111110101010111110101110111110111011101
1010000010100000100010100000100010000010001000101
1011101110101111101110101111111111111011101010101
1010001000101000100010101000000000001010001010101
1010111011101010111110101011111111101010111010101
1000100000000010000000100000000000100000100010001
1111111111111111111111111111111111111111111111111
