1111111111111111111111111111111111111111111111111
1000001000001000000000000010000000000010001000001
1111101011101011111111111010111111111010101111101
1000001000100010001000001010001000100010100010001
1011111110111111101010111010101010101110111010101
1010000010100010001010001010100010100000101000101
1010111010101010111011101010111110111111101111101
1000101010001010000010001010100010100000000010001
1111101010111010111110111010101010101110111110111
1000100010001010001010000010101000100010100010001
1110101111111011101011111111101111101011101011101
1000100000000010001000000000001000001000001000101
1011111111111110111111101110111011111111111011101
1000001000000010100000100010100010000010000010001
1110101011111010101110111010101110111010111010111
1000101010001010001000100010101010001010001010101
1011101011101011111011101110101011101011101010101
1010001010001000000010000010100010001010001010101
1011111010101111111111111010111010111010111010101
1000100010100000100010001010101010001000100010101
1110101110111110101010101110101011101111111110101
1000100000100010001010100010100010100000000000101
1011111111111011111010111010101110111111111111101
1010000000000000001010001000101000001000100000001
1010111111101011111011101111101110101010101111101
1010001010001010000010001000100000101010100010001
1011101010111110111110111010111111101010111010101
1000100010000000100000100010100000100010100010101
1010111011111111101111101111101110111110101110101
1010101010000000001000000000001000000010101000101
1010101010111111111111101111111011111110101011101
1010001010001000001000100000101000001000101010001
1011101010101011101010111110101111101011111010111
1010101010100000100010000010000000101000001010101
1010101011111011111111101011101111101111101010101
1010001000001010000000101000101000001000101010001
1011101111101110111110101110111011101011101011111
1000100010001000100000100010100010001000101000001
1010101110111011101111111110101110111010101110101
1010101000100000100000000000101000100010100010101
1110101011111110111111111111101011111110111011101
1000101000100010101000001000001000000000001000101
1011111110101010101011101011101111111110111110101
1000000010001000100010100010100000001000100000101
1011111011111111101110111110111111101111101111101
1000100010000000101000000000000000100010001000101
1110101110111011101111111111101110111010111010101
1000100000001000000000000000001000001000000010001
1111111111111111111111111111111111111111111111111
