1111111111111111111111111111111111111111111111111
1010000000100000001000000000001000000010000000001
1010111110101111101110101111101111101010111110101
1010100000100000100010101000101000101000001000101
1010101111111110111010101011101010111111111011101
1000101000000000101010101000101010000010000010101
1111101110101111101011101110101011111010111110101
1000100010100010000000001000100010001010001000101
1011111010111010111111111011111110111010101010101
1010001010101010100010000000000010000010101010001
1010101010101011101011111110111010111111101011111
1000100010001000101000000010100010001000001010001
1011111111111110101111111011101111101110111010101
1000000000000010000000001000100000000010100010101
1111111111111011111111101110111111111010101110101
1010000000101000001000101010000000001000100010101
1010111010101111101010101011111111101111111010111
1000100010000010001010100010000010001000100010001
1011101111111010111010111010111010111010101111101
1000100010100010001010000010001000100010000000101
1110111010101111101111111011101110111110111110101
1000001010101000101000001000101000100010100010101
1011111010101010101011101111101011101011101010101
1010000010101010001010000010001010001000101010001
1010111110101011111011111010111110111110101011101
1010001010001000001000001000100010100010001000101
1111101010111111101011101111101010101011111110101
1000001000100000001000100000101010001000001000101
1010111111101111111110111110101011111110111011101
1010100000101000000010100010001010000000100010001
1010101110101011111011101011111010111111101111111
1010100010101000001000001000001000000000101000001
1011111010101111101111111111101111111110101011101
1010001010100000001000001000100010000000101010101
1010101010111111111011101011111010111111101010101
1010101010100000000010000010000010101000100000101
1010101010101111111010111110111110101010111110101
1010101010100000100010001000100000101010100010101
1010101010111110101111101011101111101010101011101
1010100010000010100010001010101000001010001000101
1010111111101110111011111010101011111011111110101
1000100010100000101000100010101000001000000010001
1011101010111111101110101110101111101111111011101
1010001010100000001010101010000000001000000010101
1010111010101110101010101010111110111011111110101
1010100010000010100010101000100010100010000010001
1010101111111110111010101111101011101110111110111
1000100000000000100010000000001000001000000000001
1111111111111111111111111111111111111111111111111
