1111111111111111111111111111111
1010000000000000100010000000001
1011111110111110101011101110101
1000000010100000101000101000101
1111111010101111101110111011111
1000001000100010001000100010001
1010111111111011101110101110101
1010000000001000100010100000101
1011101111101110111010101111101
1000101000101010000010101000101
1111101010101011111110111010101
1000001010100000100010100010001
1011111010111111101010101011111
1000100010000000001000101010001
1110101111111111111111101110101
1000100000100010001000000000101
1010111110101110101011111111101
1010100010100010100010001000001
1010101010101010111110101011101
1010001010101010100010101010001
1011111010111010101110101010111
1010001010001000001000101010001
1010101011101111101011101011101
1010101000100010001010100010101
1010101111111011111010111110101
1010100010001000000010000010101
1010111010101111111110101010101
1010101000100000000010101000101
1010101111111111101110101111101
1000000000000000100000100000001
1111111111111111111111111111111
