1111111111111111111111111111111
1000000000000000001000100000001
1111111111111111101011101011101
1000100000000010101000001010101
1010101110111010101011111010101
1010101000100010101010000010001
1010101011101110101110111110111
1010101000100000100010001000101
1010111010111111111010101110101
1010001010100000001010100010001
1011101010101111101010111011101
1010101010101010001010100010001
1010101110101010111010101111111
1010000000101010000010100000001
1011111011101011111110111111101
1000001010001000000010001000101
1011101110111110111011101011101
1010100010100000101010101010001
1010111010111011101010101010101
1010001000100010100010101010101
1011101111101110101110101010111
1000100000001000101000101010001
1110101110111011101011101011101
1010101000100010001010000000101
1010111011101010111010111111101
1010100010001010101000100000001
1010101111101010101011101111101
1010100000101010100010001000101
1010111110101010111110111011101
1000000000101000000000100000001
1111111111111111111111111111111
