1111111111111111111111111111111
1000001000100000001000100000101
1111101011101110111010101010101
1010001000001000100010001010001
1010111011111010101111111011111
1000101000001010100000001000001
1011101110111010111110111110101
1010000010100010100000100010101
1011101010101111101111101010101
1000101000100000101010001010101
1110111011111110101010111011101
1010001000000010001010100000001
1011101111111011111010111111101
1000101000001000100010001010001
1010101110101110101111101010111
1010100010101000100000101000001
1010111010101011101110101111101
1010100010100010001010100010001
1011101110111110111010111011111
1000001010001000000010001000001
1011111011101111111110101111101
1000100000000000000000101000001
1110111111111111111111101011111
1010001000100000000000001010001
1011101010111111111111101010101
1000100010000010000000101000101
1110111111111010111110111111101
1000000010001000100000100000101
1011111110101111101111101110101
1000000000100000000000001000001
1111111111111111111111111111111
