1111111111111111111111111111111111111111111111111
1000000000101000100000000000000010001000000000001
1111111110101010101110101111111010101110111111101
1000000010100010000010101000001000100000101000101
1110111010111111111110111011101111111111101010101
1000100010000000000010000010100000000010001010001
1011111111111111111010111110111111111011101011111
1000000000001000000010100000000000001000100010001
1011111011101011111110111111101011101110101110101
1000100010001010001000000000101010000010100010101
1110101111101010101111111110101011111010111011101
1000100000101010100010001000101010001010001010001
1011111110101010111010101011111010101111101010101
1010000000101010101010100000000010100000101000101
1010111111101010101011111111111010111110101111101
1010000000101000100010000000001010100000100010101
1011111110111111101110111111101010111110111010101
1000100010000000001010001000101010000010000010001
1110101011111111111010101010101011111011111110111
1010001010000000000000101010001010001010001000101
1011111010111111111111101110111010101011101011101
1000001010100000001000100010001010101010001010001
1011111011101111101010111011101110101010111010101
1000001000001000001010100010101000100010001000101
1011101111111011111010101110101011111111101111101
1010000000001010000010101000101000000010000000101
1010111111111010111110101010101110111010111011101
1010001000001010000010001010100010001010001010001
1111101011101010111011111110111011111011101110111
1000100000101010001010000000001000001000100000101
1010111111101011101010111111111111101110101111101
1010000000101000101010001000000000101000100000101
1011111110101110101011101011111010101011111110101
1000001000000010101000100000100010100010000010101
1011101011111010101110111111101110111110101010101
1000101010001010101010000000100010000010101010101
1110101110101110101011111110111011111011101010101
1000100000101000100010000010001010000000001010101
1011111111101011111010111111101011111110111110101
1000100010001010001010100000001010001000100000101
1110111010111010101010101111111010101111101111101
1010001010001010101010100010100010100000101000001
1011101011101011101010111010101010111110101111101
1000100010101000100000001010001010000010100000101
1010111010101110101111111010111011101110111110101
1010001010100010101000001010101000101000001000101
1011101010111010111011101010101110101011111011101
1000100000001000000010000010000010001000000000001
1111111111111111111111111111111111111111111111111
