1111111111111111111111111111111111111111111111111
1010000010001000001000000000100000100000100000001
1010111110101010101010111111101010101110111111101
1010000000100010101010000000001010001010100000001
1010111111111110101011111111111011111010101111101
1010000000000010101000000010001000100000001000101
1011111111111010101111111010101110101111111011101
1000001000000010101000001000101000101000100010001
1111101111101110111010111011111011111010101110111
1000100000101010000010100010001010000010100000101
1110111110101011111110101110101010111110111011101
1000001000100010000010000010100010100010001000001
1011101011111010101011111110111110101011101111101
1010001010100010101010000010000000001000101000101
1011111010101110101010111010111111111110101010111
1010001010001000101010100010101000100010100010001
1010101010111110101110101110101010101011111111101
1000101010000010101000101010101010001000100010001
1111101011111011101011101010101011111110101010101
1000001010001010001000101000001000000010001000101
1011111010101010101110101110111111111011111111101
1000000010100010101010100010100000001010000010001
1011111110111110101010111011101111101010111011111
1000100010000010101010101000101000001000101000001
1110111011111010101010101110101111101110101111101
1010001000000000100010100000101000100010101000101
1011101111111110111110101111101010111010101010101
1000100010001000100010101000100010001010001010001
1010111010101011101010101011101111101011111011101
1010001000101000101000101000001000001000001010101
1011101111101111101111101111111011111111101010101
1010000000100000100010100000001010001000101010101
1011111111111110111010111111101010101010101010101
1010000000000010100010000000100010100010100010001
1010111110101110101111111110111110111111111110111
1000101000101000101000000010000010000010000010001
1011101011101011101011111010111010111010111011101
1010001010001000100010001010100010001000101000101
1011101011111110101111101010101011101111101011101
1000001000100000100000001010101000101000001000001
1111101110101111111111111010101111101111101111111
1000101010001000000000000010100010001000001000001
1110101011111110101111111110111010111011101111101
1000100010000010101000100010001010100000100000001
1011111010111010101110101011101010111010111111101
1000001010001010100010101000101010001010001010001
1011101011101011111010101011101011101111101010111
1000100000001000000010001000001000000000001000001
1111111111111111111111111111111111111111111111111
