1111111111111111111111111111111
1010000000100000100000000000001
1010101110111011101111101111101
1010101010001000100010101000101
1011101011101110111010101010111
1010001000100010000000100010001
1010111011111010111111111111101
1000100000000010001010001000101
1111101111111111101010101010101
1000100000000000100010100010001
1110111111111110111110111111111
1000100000000010000010100000001
1010111111101111111010101111101
1010000000101000000010001000001
1011111110101011111111101011101
1010000010001000100000101010001
1010111011111110111010101011101
1010001000000010100010101000101
1011101111101110101110111110101
1000101000100010001010001000101
1010101010111011111011101011101
1010001010001000100000101000101
1011111011101110101110101110101
1010001000100000100010100000101
1010101110111110111010111111101
1010101010001000100010000010001
1010101011101111101110111110111
1010100010001000101010100000101
1010111010111010101010101111101
1000100010000010000010000000001
1111111111111111111111111111111
