1111111111111111111111111111111
1010000000000000000010001000001
1011111110111110111010101011111
1010000010001000101010101000001
1010111011111011101010101011101
1010101010001010001010101010001
1010101010101010101010101010101
1000101010101010101010101010101
1111101010101010101010101110111
1000001000100010101010100010001
1011101111111111101010111011101
1010100000000010001000101010001
1010111110111010111111101010111
1010000010100000100000001010001
1010111010111011101111101011101
1010100010001010001010001000101
1010101111101110111010101110101
1010100000100000100010101000101
1010111111111111101010111011101
1010000010000000001010100010001
1011111010101111111010101110111
1010001010100000100010001000001
1010101010111110111011111111101
1000101010000010001000000000101
1111101010111111101111111110101
1010001000100010001010000010001
1010111111101010111010101111101
1010000000101000100000100010001
1011111110101111101111111010111
1000000000001000000000001000001
1111111111111111111111111111111
