1111111111111111111111111111111
1000000010001000000000001000001
1111111010111011111011101010111
1000001010001010001010001010001
1111101011101011101010111111101
1000001000101000001010100000001
1011111110101110111010101111101
1000100000100000100010001000001
1110101111111111101111111111101
1000101000001000001000000000101
1010101011101011111011111110111
1010100010001000000010000010001
1011111110111011111111111011101
1010000000101010000000001010001
1010111111101010101111101010101
1010000000100010100010001010101
1011111110101111111010111010101
1000100000100000100010100010101
1010101111111110101110101010111
1010001000100010001010101010001
1011111011101011111010101111101
1000001000001010000010101000001
1111101011111010101110101011101
1000001000100010100000001010001
1011111011101010111111111010111
1000001010001010001010001010001
1111101010111111101010101011101
1000101010000000000010100010001
1010101111111111111110111110111
1010000000000000000000100000001
1111111111111111111111111111111
