1111111111111111111111111111111111111111111111111
1000100000000000000000100000001010000000001000001
1110111111111011111110111110101010111011101011101
1010000000100010000010000000101000001010101000101
1011111110101110111011111111101110111010101010111
1000100010101000101000100000100010100010001010001
1010101010101011101110111110111011101110111111101
1010001010101000101000100010000000101010100000001
1011111110101110101010101011111110101010111011101
1010000000100000001010101000001010001010000010101
1010111111101111111010101111101011111011111110101
1000100000100010000010100000101010000010001000001
1011101111101110111111101111101010101110101011111
1000100010001000100000001000001000101000100010001
1110111010111011101111111011111111101011111110101
1010001000001010001000001000001000001000100000101
1011101111111010111011101111101011101110101111101
1000100000001000100010100010001000101000101010001
1110111111101111101110111010111010111011101010111
1000000010001000001010001000100010100010001010001
1011111010111011111010101111111110101111101011101
1000001010001000100000100000000000100000100000101
1111101011101010111111101111111110111110101111101
1000001010001010001000100000001000100010101000101
1011111010111111101010101111101011101010111010101
1000001010001000001010100000101010001000100010101
1111101011101011111010111111101010111111101110101
1000001000100010001010000000101010100010000010001
1011111110111110101011111110101110111010111011111
1010001000000000101010000010100010001010101000001
1010101011111111101010111110111011101010101111101
1000101010001000000010001000000010001000000010001
1011101110101111111110101011111110111111101110101
1000101000100000100000101010000000100010001000101
1110101011111110101111101010111111101011111011111
1010100010000000100000100010100000001000001000001
1010111110111111111011111110101110101111101111101
1000100010100000001010000000100010101000100000001
1011101010101111101110111111111010111010111011111
1010001010001000101000100000001010000010100010001
1011101011111011101011111011101011111110111110101
1000101000000010001000000010001010000000100010101
1110111111101110111111111110111110111111101010101
1000100000001000100000000010000010000000001000101
1011101111101011101011111111111010111111111111101
1000100000101000101010000000001010001000001000001
1110111110101110101010111110111011111011101011101
1000000000100010001000000010000000000010000010001
1111111111111111111111111111111111111111111111111
