1111111111111111111111111111111111111111111111111
1010000000000000001000100000100000000010001000001
1011111110101111101010101011101111101110101011101
1000100010101000000010101000000000100010100010001
1110101011101111111111101111111111101010111110111
1010001000100010000000001000001000101010100010001
1011111110111010111110111011101010111010101011101
1000000010001010100010100010101010100010001000101
1011111011101010101011101110101010101111111110101
1010001000101000101010001010001010100000000000101
1010101111101111101010111010111010111111111111101
1010100000100010001000100010001010000010000000101
1010111110111010111111111011101011111010111110101
1010001010000010100000000010001000001000100010001
1011101011111110101111101110111011101111101111101
1000100000100000100010100000100010001000100000001
1010111110111011111010111111111110111011101111111
1010001010000010001010001000000000100000100000001
1010101011111110111010101010111111111110111111101
1010100000001010001010100010100000000000001000101
1010111111101010101010111110101011111110111010101
1010100010001010100010000010101010100010100010001
1010101010111010111111101110111010101010101111111
1010101010000010101000001000100010001000101000001
1110101010111110101011111011101111101111101110101
1000101000100010100000100010000000100000100010101
1011101111101010111111101111111110111011111011101
1010001000001000100000001000000010001010001000101
1011101011111111101111111010111011101110101110101
1000101000000010100000101010001000101000100010001
1010111111111010101110101011101110101011111011101
1010001000000010000010101010001000001000001000101
1011101011111111111010101010111111101111101011101
1000100010000000001010100010000000101000001010001
1110111111101111101010101111111110101011111010111
1010000000101000001010100010100000101000101010001
1011111110101011111110111010101111111110101011101
1010000010001010000000101010100000000000001000101
1010111011111010111011101010111111111111111110101
1000101010001010001010001000100000001000000000101
1011101010101011101010101110111111101011111011101
1000101010100010001010100010100000001010001010001
1110101010111110111011101110101111111010101010111
1010001000100010100010001000101000000010100010001
1011101111101011101110111011101011111110111111101
1000100000101000001000100010001000100000001000001
1010111110101111111011101110101110111111111011111
1010000000001000000000000000100010000000000000001
1111111111111111111111111111111111111111111111111
