1111111111111111111111111111111
1000000010000000000010001000001
1111111011111011111010101011101
1000001000000010000010100000101
1011111111111110111111111011101
1000000000001000100000001010001
1011101111111011101011101010111
1000101000001010001000101010001
1110101011101011111110101111101
1010100000101000100010100000101
1010111111101110101010111110101
1010001000100010001010000010101
1010111010111011111011111010101
1000100010000000001000100010001
1011101111111111101110101111101
1000100000001000100010101000001
1110111111101010111010101011111
1010000010101010000010001010001
1011111010101011111111111010101
1000100010101000100000001010101
1011101110101110101111101011101
1000001000101000101000001000001
1011111010101110101111111111101
1010000010100010001000000000001
1010111010111011101011111111111
1010100010101010001010000000001
1011101110101011111010111011111
1000101010101000001010001000001
1110101010101111101011111111101
1000001000000000100000000000001
1111111111111111111111111111111
