1111111111111111111111111111111111111111111111111
1000000010000000100000001000000000100000000000001
1111111010111110101111101111111110101110111111111
1010001000100010001000100000100010100010001000001
1010101111101011111110111110101010111011101011101
1010100000001000000000100010101010000010101010001
1010111111111010111110111010101011101110101010111
1010100000001010100010000010001000100010100010001
1010101110111011101011111011111110111010111111101
1010101000100010001000001000000010100000000000101
1010101011101110111111101110111110111110111110101
1010001010100010001000001000100010001000100010101
1011111010111011101011111011101011101111101011101
1000001010001000101010000010001000100000001000001
1011111010101011101011111110111110111111111111101
1010000010101000001000000000100010001000000000101
1010111111101111111111111111101110101111101010101
1010001000000000100000100000001000101000101010101
1011101010111110101110101110101011101010111010101
1000101010100010001010100010101010001010001010101
1011101010101011111010111010111010111011101011101
1000101010001000001000100010001010000010000010001
1010101111111110101110111011101011111011111110111
1010100000000010100010001000101010000010000000101
1110111111111011111011101111101011101110111111101
1000000010001010000010100000001000101010001000001
1011111010101010111110111111101110101011101011101
1010001000101000100010000010101010100000101010001
1010101111101111101010111010101010111110101010101
1010100010000000001010100000101010100010101010101
1010111011111111111010111111101010101011101010101
1000001000100000000000100000001010101000001010101
1011111110101111111111101111111010101111111110101
1010000000101010000000101000001010100000000010101
1010111111101010111110101010101010111111111010101
1010000010001010100000101010101010000000001010101
1011111010111010101111101110101011111110101010101
1000100010000010100000001000101000100010101000101
1110101111111110111111111011101010101010101111101
1010100000100000100000001010100010101000100010001
1010111110101111101110101010111110101011111110111
1010100010001000000010101010000010101010000000101
1010101011111111111110101010111010101110111111101
1010001010001000001000101010101000100000100010001
1011111010101011101011101010101111111111101011101
1000001000101010101010101010100000000010001000101
1010111111101010101010101010111111101011101110101
1010000000000010000010000010000000001000001000001
1111111111111111111111111111111111111111111111111
