1111111111111111111111111111111111111111111111111
1010001010000010000000001000001000001000001000001
1010101010111010111110101110101110101110101110101
1010101000001000001000101000100010101000100000101
1010101111111111111011101011111010101011111111101
1010100000000010001010101000100000100010000000101
1010111111111010101010101010111111111110111111101
1000101000001010100010001010001000100000000000001
1111101011101010111110111111101010101111111111111
1000001010001000100000100000001010100000001000001
1110111010111111101111101111111011111111101011101
1000100010001000001000000010100000100000100010001
1011101111101011111111111010101110101010111110111
1000101000100010000000000010100010001010000010101
1110101110111111101111111110111011111011111010101
1000101000100000101010000000100010001010001010001
1010101011101010101010111011101110101010101111101
1010101010001010101010001000001010101000101000001
1011101010111010101011101111111010101111101011111
1000001010101010001000100010000000100000100010001
1011111010101011111110111010111111111010111111101
1010000000001000100000100010000010001010100000101
1011111111111110101011101111111010111010101110101
1000001000000000101010001010001000100010001010001
1111101011111111101010111010101110101111111011101
1000100010000000101010100000100010100000100010001
1010111110111110101010111011111010111110101010111
1010000000101000101010001010001000001010101000101
1010111111101011101111101010111111101010101111101
1010001000100010000000101000100000100010101000001
1111101010101111111110101111101110111110101011101
1000100010100000000010101000100010100000101010101
1010111110111111111010101010101010101111101010101
1010100000101000000000100010101010001000100010001
1010101111101011111111111110111011111010111110111
1010001000100010000010000010001000100010000010001
1011111011101110111010101011101110101111101011111
1010001000000000100010101000100010101000101000001
1010101111111111111110101111111010101010111111101
1000100000000000000010101000100010001010000000101
1011111111111111111010101010101110111011111110101
1010000000000000001000100010001010101000100000101
1010111111111111101111111111111010101110101111101
1010100000000000100000000000100000001010100000101
1011101111111110101111101010111111101010111110101
1000101000000010101000101010000000100010100000101
1110101011101110111010111011111110111110101111101
1000001000100000000010000010000000000000100000001
1111111111111111111111111111111111111111111111111
