1111111111111111111111111111111
1010001000100000000000000010001
1010101010101111111111111010101
1010100010101000001000001000101
1010111110101011101011101111101
1010101000100010001000100010001
1010101011111110111010101110101
1000101010000000100010101000101
1111101010111111111110111011101
1000001010000000001000100010001
1010101011111111101010101110111
1010101000000000101010101000101
1110101111111110101010101011101
1000100010000010100010101000001
1011111011111010111111101111101
1010001000000010000000100000101
1010101111111111111110101110101
1000101000000010000000100010101
1111101011111010111111111010101
1000001000101000100000100010101
1011101110101111111010101110111
1010000010000010001010001010001
1011111011111010101011111011101
1010001000001010101000000000101
1010101111101010101111111111101
1000100010001000100000001000001
1011111011101111111111101011101
1010001000100010000000100010101
1011101110111110101111111110101
1000000010000000100000000000001
1111111111111111111111111111111
