1111111111111111111111111111111
1000100000000000000000001000101
1110111011111111111111101010101
1010100010000000100000101010101
1010101111111010101011101010101
1000101000000010001010001010101
1011101010111111111110111010101
1000101010100000000010000010101
1110101110101111111011111110101
1010101000100010000010000010101
1010101011111010111010101110101
1010001000000010100010101000101
1011111011111110101111101011101
1010001010000000100000001000001
1010101010111111111111101111101
1000101010000000001000101000101
1011101011111111101110101011101
1000101000000010100010000010001
1110101111111010111011111110111
1010100000001000001000000010001
1010101110111111101111111011101
1000101000100000001000100010001
1011101111101111111011101110111
1000100010001000100000100010101
1110111010111110101110111010101
1010001010000010001000100010101
1011101011111011111011101010101
1010001000001010001000101010101
1010111111101010101110101110101
1000000000100000100000100000001
1111111111111111111111111111111
