1111111111111111111111111111111111111111111111111
1010000010000000000010000000000000000010001000001
1010111010101111111010111111111111111011101010111
1010001000100000001010000010001000001000100010001
1011111011111111101011111010101010101110101111101
1000001010000000001000000010100010100010101000101
1111101010111111111111111110111110111010111010101
1010001010000000100000000010100010101010001010001
1010111011111110101111111010101010101011101011101
1010001000100000101010000010101010100000100010101
1011101110101111101010111010111010111110111110101
1000100010101000101010001010100010000010100000101
1110111011101110101011101110101111111010111011101
1000001000101000101000100000100010000010000010001
1011111110101011101010111111111010101111111110111
1000100000101000001010000000100010101000000010001
1010101111101110111111111010101010111011111011101
1010100010000010001000000010001010000010000010001
1010111011111011101011111111111011111110111110111
1010001000000010100010100000001000000010100000101
1111101111111110111110101111101111111010101111101
1000001000000000000000100010001000000010001000101
1011111011111111111110111010101011111111111010101
1010000010000010000010000010101000000010000010001
1010111110101110111010111110111111111010111111101
1000100010101000100010100000100000001000100010001
1011101011101011101111101110101111101111111010111
1000001000101000100000001000101000100000000010101
1111111110101110111111111011101010101110111110101
1000100000001010001000100000100010101000100010001
1011101111101011101011101111111110101111101011101
1010001000100000101000100010000010100010001000001
1010111010111011101110111010111010111010111111111
1010100010001010001000001010101010101010100000001
1010101111101110111011111010101010101010111011101
1000101000100000100000000010001000101000100010101
1011101010111111111011111111101111101111101110101
1010001010100000001010001000001010000010001000101
1010101010101111101010111011111010101010101011101
1010101010001010001010001010000000101010101000001
1010111011111010111011101011101111101011101011111
1010000010000010101000001000101000001000101000001
1011111111101110101111101110101011111110101111111
1000001000001000100000001000101000000010100000001
1111101110111010111111111011101111111010101111101
1000100010001010100000100010001000000010101000001
1010111011101011101110101111111011111110111011101
1010000000001000000010000000000010000000000010001
1111111111111111111111111111111111111111111111111
