1111111111111111111111111111111
1000000010000000100000001000001
1111111010111010101111101110101
1000001010001010001000100000101
1010111011111011111010111111101
1010001000001010000010100000001
1111101111101010111110101111111
1000000010001000100010100000001
1011111110111011101110111111101
1000000010101010001000100010001
1011111010101010101011101011101
1000100010101010101010001000101
1011101110101011101010111110111
1010001000101000101000100010001
1010101011101110101111111011101
1010101010000010000000001010001
1010111011101011111111101010101
1010001000101000001000100010101
1011101110101111111010111010101
1010001000100010000010100010101
1010111011111010111110101110101
1010000010000010100010001000101
1011111110111110101011111011101
1010000000100000101000101010001
1010111110101111111010101010111
1010100010000000000010001010001
1011101011111111111111101011101
1010001000000000000000101010101
1010111111111111111110111010101
1000100000000000000000000010001
1111111111111111111111111111111
