1111111111111111111111111111111
1010001000000000101000000000001
1010101111111010101010111111101
1000100010000010001010001000101
1111111010111110111011101110101
1000000010001010100010001000101
1011111111101010101110111011101
1010000000101000100010001000001
1011101110101111111011101111101
1000101010100000001000100000101
1110101010111010111110111110111
1010001010001010000010100010001
1011111011101011101010111011101
1000100000101010001010000000101
1011101010101010101111101111101
1000001010101010101000001000001
1011111011101010101011111011101
1010000010001010101010100010001
1010111110111110111010101110111
1010100000100010000010100010001
1010101111101011101110111011101
1010100010001000100000001000101
1110111010111110111111101110111
1000100010001000001000000010001
1011101110101111101111111110101
1000101000100010000000000010101
1010101111111011111111111011101
1010100000001000001000001010001
1010111111101111101011101010101
1010000000000000001000100000101
1111111111111111111111111111111
