1111111111111111111111111111111111111111111111111
1010000010000000101000001000000000100000000010001
1010111010111110101011101011101110101111111011101
1000101000100010101000100010100010001000100010001
1111101111101110101110111110111011111011101110101
1000000010001000100010100000001000100000000000101
1010111010111011101010101111101110111111111111101
1010001000100010001000001000100010001000000010001
1011101110101111111111111010111011101011111010111
1010100010100000000000001010001000100000001010001
1010111010111111111111101010111110111111111011111
1000100010000010000000101010000000000010001010001
1111101111111010111010101111111111111110101010101
1000001000100010100010100000100000100000101000101
1011101010111010101111111110101110101111101111101
1000101010001010100010000010001010001000101000101
1010111011101010111010111011111011111011101010101
1010100010001010101000101010000000100010001010101
1110101110111110101111101010101110111010111010101
1000101010000010000010001000101000000010100010001
1010101011111011111011101111101111111010101011101
1010100000001000000000101000100010100010101000101
1011101111111111111110101010111010101110111110111
1010001000000000001010100010001010100010100010001
1010111011111111101010101111101010101110101011101
1000101010100000001010100000101010001000101000001
1011101010101111111010111110101010111011101111101
1000001010101000100010000010101010001000100010001
1111111010101110101011111011101011111110111010111
1000001010100010001010000000001010000010000010101
1011101010111011101010111111101010111011111110101
1000100010001000101000100010001010101000001000101
1010111110101110111111101011111010101110101011101
1010001000100010100000101000001010001000101010001
1111101110111110101110101111101011101011111010111
1000100010000010101000100010000000101000001010001
1010111011111010101011111011111111101111101011101
1010000010000010001010001010000000101000101000101
1011111110111111111010101010111110101010101110101
1000001000000000000000100010100000101010100010101
1011101011111111111011111010101111101110111010101
1010101010100010001010001010100000100010100010101
1010101010101010101110101110111110111010101110101
1010101000101010100010101000000010001010100000101
1010101111101010111010101011111110111010111111101
1000100010001010001010100010000000100010000000001
1110111010111011101010111110111111101111101111101
1000001000001000001000000010000000000000001000001
1111111111111111111111111111111111111111111111111
