1111111111111111111111111111111111111111111111111
1010001000001010001000000000001000100000000010001
1010101110101010101011111110101010101111111010111
1010100000101000100010000000100010100000001010001
1010111111101111111110111111111110101111101011101
1000100000100000000000101000000000100010001000101
1111101111111111111111101011111111111010111110101
1000100000001000100000001010000010001010101000101
1010101110101011101111101010111110101010101011101
1010000010101000100000100010000010100010100000101
1011111110101110111110111110111010111110111110101
1010100000100000001000100010101000100010001000101
1010101111111111101011101010101111101011101011101
1000100000000000101010101000100000101000001000001
1110111111111010111010101111101010101111111111101
1010100000001010100010000000101010100000001000001
1010101111101110101111111110101011111011101011111
1010101000100000101000100010101010001010001000101
1010101010111110101010101010111010101110111110101
1000101010000000101010001010000010100010001010101
1111101011111111101011111011111010111011101010101
1000001000100000001010001010000010101000101000101
1011101111101111111010101011111110101110101011101
1010001000100000001010101010000010100000001000001
1011111010111111101011101010111010111111111111101
1010000010001000100010001000100010000000000000101
1010111110101010111110111111101111111011111110101
1000100010100010000000100000001000001000100010101
1011101010111111111110101111111011101110101110111
1000001010100010000010101000000010001010100010001
1111111110101010111010101011111110111010111011101
1000100000101000101010100010000010100000000000101
1010101111101111101010111110111110101111111111101
1010100010001000001010100010000000101000000000001
1010101010111011111010101110111111111011111111101
1010101010100000001010001000100010000010100000001
1010111010111110101011111011101010111110101111111
1010001010100010101010000010001000100000101000101
1011101010101011101010111111101111101110101010101
1010101010101010001010101000001000001000100010101
1010101010101010111010101010111010111011111110101
1010001010101000100010100010100010001010000010101
1010111010101110101110111110101111101110111010101
1010100010100010100010100000100010101000101010101
1010111010111011111010101111111010101011101010101
1010000010001010000010101000000010101010001010101
1011111111101010111110101011111110101010101010101
1000000000000010000000001000000000100000101000001
1111111111111111111111111111111111111111111111111
