1111111111111111111111111111111
1010000000100000001000001000001
1010111110101110111011101011101
1000100010101010000010101010001
1111101110101011111110101010101
1010000000101000001000100010101
1010111111101110101110111110101
1010000010100000101000000010101
1011111010111111101011111010101
1000001010100000101010001010101
1010111010101011101010101010101
1010001010001000000010101010101
1011101011101111111110101110101
1010101000100000001000100010101
1010101110111011111011111010101
1000100010100010001010100000101
1011111010111110101010101111101
1010001010001000100010001000101
1010101011101011111111111010101
1010101000101000000000001010101
1110101110101111111111101010111
1000100000101000100000100010001
1011111111101010101110111011101
1000000000100010001010001010001
1011111110111111111011101110111
1000000010100000000000100010001
1111111010101110101111111011101
1010001010001010101000000010001
1010101011111010111011111110101
1000100000000010000000000000101
1111111111111111111111111111111
