1111111111111111111111111111111111111111111111111
1000001000000000001000000000100000001010000000001
1111101110111111101011101110101011101010111111101
1000100000100000101010001010101000100010001000001
1110111111101111101010111010111110111011101011111
1000001010000000101010100000100000100000101000001
1011101010111110101110101111101111101111101111101
1000101010001000100000100000100010001000001010001
1110101011101011111111111110101011111011111010101
1000100010101000001000000010101000000010001010101
1011111010101110101011111010101111111110101010111
1000001000101010100010001010100010000010100010001
1011101110101010111111101010111010111010101111101
1000100010100010000010001010001000101010101000101
1011111010111011111010111011101111101010101010101
1010000010101000100010000010001000101010101010101
1010111110101110101011111110111010101010101010101
1010100000000010101010000000100010001010101010001
1010101111111010101110111111101010111010101011101
1010101000100010100000100000101010100010101000101
1110111010111110111111101011101011101110111110101
1000100010000000100000101000101000000000100000101
1011101111111111101011101110101111111011101111101
1000001000000010001010000010001000001010001000101
1011111011101110101110111111111011101110111110101
1010001000101000100000100000001010000010000010001
1011101010111011111111101111101011111011111010111
1000101010000000001000001000101000101000100010101
1110101011111111101011111010101110101110101110101
1010101000100010001000100010100000100010001010001
1010101110101011111010101110111111101011111011101
1000100000101010001010100010000010001000001000101
1011101111101010101110111011101110111111101010101
1010001010001010100000100000100010001010001010001
1011101010111010111111101111111011101010111011111
1000100010001000101000001010000010001010000010001
1110111111101111101011111010111110111011111110101
1010001000001000001000001010000000100010001000101
1011101011111011101111101011111111101010101011101
1010001000101010100010001000001000001000101010001
1010111110101010101110111110111011101111111010111
1010100000101000100010100010100010001000001010001
1010111011101011111010101010101110111011101011101
1010001000101010000010001010001010000000101010101
1011101110101010111111111010111011111111101010101
1000100000101010100000001010000010000000100000101
1010111111101010101011111011111110111110111111101
1010000000000010001000000000000000100000000000001
1111111111111111111111111111111111111111111111111
