1111111111111111111111111111111111111111111111111
1010000000001000101000000000001000000000100000001
1011111011101010101011111110111011101011101110111
1000000010101010100000100010000000101010001010001
1111111110101010111111101011111111101110111011101
1000100000100010000000001000000000100000000000101
1011101010111111111111111111111110111111111111101
1000001010000010000010001000000010000000000000101
1011111011111010111010101011111011111111111110101
1000100010000010001000100000100010000000000000101
1110101110111111101111111011101010111111111111101
1000101000000000101000001010001010001010000000101
1011101111111110101011101110111011101010111010101
1010101000001000101010100010100000101000101010001
1010101011101011111010111010101111101011101011101
1010100010001000001010100010100010001010001000101
1010111110111111101010101110101110111010101110111
1000100010100000101010100000101000101000101010001
1110111010101110101010101111111011101111101011101
1010100010101000100010001000001010000000100010101
1010101010101011111011111011101011111110111010101
1010001010001010001010001000101000000010100010101
1011111011111010101110101110101111111010101110101
1000101010001010100000100010100010000010000000101
1010101011101010111111101110111010111111111011101
1010001010001010000010101000101000100000001010001
1011101010111011111010101011101111101111101010111
1010001000100000001010100010000000001000001010001
1011101110101111111010111110111110111011111110101
1000101000101000000010100000000010101010000010101
1010111011101011111110101111111110101011101011101
1010100010100010000000000010000000100010001010001
1010101110111111111111111010111111101110111010111
1010001000000000000000001010000010101000101010001
1011111110101111111111101110111010101011101011101
1000000010100010000000100010101010100010001000101
1111111011111010111110111010101010111110111110101
1000001000001010000010001010001010000000000010101
1011111111101011101111101011111010111111111010101
1010000000001000101000101000000010100010000010101
1010111111111010101010101111111110101110111110101
1010000000001010101010101000000010100010000000101
1011111111101010111010101010111110101011111111101
1000100000001010000010100010000000101000001000001
1010101111111111111110101111111111101111101011101
1010101000001000000000101000000000101000100010001
1011101110101011111111101111101110111010111110101
1000000000100010000000000000001000000010000000101
1111111111111111111111111111111111111111111111111
