1111111111111111111111111111111111111111111111111
1000101000001000100000001000000010000010000000101
1110101011101010101011101111101010101010111110101
1000100000100010001010001000101000101000101000101
1011111110111111111010111010101111101111101011101
1000000010000000001010000010101000101000100000101
1111111011111110111011111110111010101010111110101
1000001010001010100010000010001010001010100010101
1011111010101010101010111011101011111010101010101
1010000010100010101010001010101000100010001010101
1010111110111110101110111010101110101111111010101
1000101000100000100000100010000000100010001010101
1011101010101111111111101111111111111010111010101
1010100010000000000000100000000000001000100010001
1010101111111111111110111111111110111110101111101
1010000010001000000000100010100010000000101000001
1011111010101111111110101010101011111111101110111
1000100010100000100010101000101010000010100010001
1110111110111110101010101111101010101010111011111
1010000000100010101010100000001000101000001000001
1011111111101110101010101111111111101111101111101
1000001000100010001010100010000000101000101000101
1010101010111011111010101110111110101011101110101
1010100010000000001010101000100010001000000000101
1010111111101111111010111011101011111011111111101
1010100000101000000010000010001010000010100000101
1010101110101011111111111110111010111110101110101
1010100010101010000000100010001010100000100010001
1010111010111010111110101011101110101110111011101
1010001010001000101000101000100000101000100010001
1010101011101111101011101110101111101011101110111
1010101000100000001000001000100000001000101010001
1010111110111110111111111011111111101111101011101
1010000010100010100000100010001000101000101000001
1011101110101010101110101110101011101010101111101
1010100010101010101000100000101000001010001000101
1010111010101010101010111111101011111011111010101
1000001010101010001010100010001000001000000010101
1111101010111011111011101010111111101111111110101
1000101010100000101000001010000000100010000010101
1110101010101110101111111011111110111011101110101
1000101000100010000010000010000010100000101000101
1010101111111011111010111110111010111110101011101
1010100010001000100010000010101000100010001010001
1010111010101110101111111010101111101011111010111
1010100010100010101010000010000010001000000010101
1011101110111010101010111111111010111111111110101
1000000000100000100010000000000000100000000000001
1111111111111111111111111111111111111111111111111
