1111111111111111111111111111111111111111111111111
1010000000100000000000001010001000001000001000001
1010111110101111111011101010101010101010111011101
1000100000100010001000101000100010101010001010001
1111101111111110101110101111111110101111101010111
1010001000000010101000100000000000100000100010001
1010111011111010101011111111111111111110111111101
1010100010100010101000100000001000000010100000001
1010101010101110101110101111111011111010101111111
1000101010001000100000100000000010001000100010001
1011111011101010111111101111111110111111101010101
1000001000101010101000001000001000000000001000101
1111101110101110101011111011101011111111111111101
1000100000100000100010001010001000001000100000001
1010111111111111101111101010101011111010101111101
1010001000000000100000100010101010001010001000001
1111101010111111111110101110111010101011111111111
1000001010000000000010100010001010101000000010001
1011101011111110111110111011101010101111111010101
1010001010100000100000100010100010100000001010101
1011111010101011101111101110111110111111101010101
1000000010101010001000100000000010100000101000101
1011111110101110111110111111101110101111101111101
1010000000100010100010100000101000100000100000001
1010111110111010101010101011101011111010111111101
1000100010101000101010001000001010001010000000101
1111101010101111101010111111111010101011111010101
1000101010001000001010001000100010101000100010101
1010111011101011111011111010101110101110101110101
1010001000101010001000000010100000100010100010101
1011101010101010101111111110111011111010111011101
1000100010101010101000000010001000100010001000001
1110111111101010101111101011101110101111101111111
1000100000001000101000001000101010100010001000001
1011101111111111101011111110101010111011111011101
1000101010000000001000001010101000001000100010001
1110101010101111111111101010101111101110101110101
1000101000100000100000101000100000101000101010101
1011101011111110101110101110111110111010101010111
1010001000000010101010100010100000100010100010001
1010111111111010101010101010101111101111111011101
1010100000001010000010101010101000000000100010001
1010101111101111101110101010101110111110101110101
1010001000100000101000101010100010100010001000101
1011111110111110101011101010111011101011111011101
1000000000001000101010001010100010001010001010001
1011111011111011111010111011101110111010101010111
1000001000000000000010001000000000100000100010001
1111111111111111111111111111111111111111111111111
