1111111111111111111111111111111111111111111111111
1010000010100000100000000010000000001000000000001
1010111010101010101111101110111110101011111011111
1000100010001010001000101000100000101000001000001
1111101111111011111010111011101111101110111111101
1000100000100010001010000010100010101000100000101
1010111110101010101011111110111010101111101110101
1010000010101010101010000000001010000000001000101
1010111110101110101011111111101011111111111011101
1010001000100000100010001000001000001000001000001
1011101011101111111010101011101111101011111111101
1010100010000010001000101010100000101000000000101
1010111111111110101111101010111110101110111110101
1000001000100000101010001010000010100010001010001
1111101010101111101010111010101010111011101011111
1000100010101000001000000010101010100010000000001
1011111110101011111111111110101110101111111011111
1010000010001010000010000000101000100000001010001
1010101111111010111010111111101011111111101110101
1000100000001000100010100000100010001000001000101
1011111110111111101110101111111110101011111011101
1010000000100000101000100000000000101000000010101
1010111111101011101011101111111011101111111110101
1010000000001000101000100000001000100000100000101
1011111110111110101110111111111110111110111010101
1000100010100010100010000000000000100010100010101
1111101010101010111011111111111111101110101011101
1000101010101010001000000000000010000000001010001
1010101011101011101111111111111011111011111110101
1010001010001000100010000000001000001010000010101
1011111010111110111010111110111111101010111010111
1000001010100000000010100010001000001010100010001
1011101010111111111110101111101011111110111011101
1000101000100000000000100000101010000010001000001
1110101110101111111111111011101011101011101111101
1000100010100010000010001010001010001000100010001
1011111010111011101010101010111010111110111010111
1010001010001000101000100010100010000010000010101
1011101011111110101111111010101111111011111110101
1010001000000010100000001010001000001010000010001
1010101111111010101111101111111110101010111011111
1000100000101000100000100000000000101000101000001
1111111110101111111110111111101111101110101111101
1000000010001000100000100010001000100010001000101
1010111111101010111011101010111010111011111010101
1010000010001010001010001010001010001000000010001
1011111010111011101110111011101010111111111111101
1000001000000010000000100000001010000000000000001
1111111111111111111111111111111111111111111111111
