1111111111111111111111111111111
1010001000001000000000001000001
1010101110101011101111101110101
1010100000101000100010100000101
1010111111101111111010111111101
1010100000101000000010000010001
1010111011101011111110101110111
1010001000101000100000100000101
1011101110101110111111101111101
1010001000100010000000100000101
1010111010111010111110111110101
1010100010001010100010100010001
1010111011101010101010101011101
1000100010001010101000101000101
1111101110111011101111101110101
1000001010101000100000100010101
1011111010101110111110111010111
1000001010100010000010001010001
1011101010111011111011101011101
1010101000000010001010001010001
1010101111111010101010101010111
1000100000100000101010101010001
1111111110101111111010111011101
1000000000100010001010000010001
1011111111111010101010111110101
1010001000001010101010001010101
1010101011101010101011101010101
1010100010101010101010000010101
1010111110101110101011111110101
1000000000100000100000000000101
1111111111111111111111111111111
