1111111111111111111111111111111111111111111111111
1000100000000000001000100000000000001000001000001
1110101011111111101011101111111011111010111011101
1010101010000010001000001000001000000010000010001
1010111010111010111011111010111111111111111010111
1010001010100010101000100010000000100000001010001
1011101010111010101110111011101111101111101111101
1000101010001010100010001000100000100000101000001
1010101011101110111011101110111110111110101011101
1010101000101000100000101010100010000010100010001
1010101110101011101110101010101111111010111011111
1010100000101010001000101000100000100010001010001
1011111111101010111111101011111010101111101110101
1000000000100010100010001010000010100000101000101
1110111110101110101010111010101111111110101011101
1000100010101000101000100010101000001000100010001
1011101011101110101111111010101011101011111010101
1010001000100010000000001000101000100010001010101
1010111110111011111111101111111110111010101110101
1010101000001000001000000010000000100010100000101
1010101011101111101111111010111011111110111111101
1010001000100000100010001000100010001000100000101
1011101110111110111010101111111110101011101111101
1000100010000010101000100000100000100010100000101
1110111011111010101111111110101111111110101110101
1000001000100010001000000010100000100000000010001
1011111011101111101011101110101110101111111011111
1010000010001000001010101000101000101000101000101
1010111110111011111010101011111011111010101110101
1000100010001000100010001000001000001010100010101
1011111011101110101110111111101111101010101110101
1000001010001000001010001000100000100010100000101
1111101010111111111011101010111110111110101111101
1000001010100010000000001010000010100000100010001
1011111010101011101111111010111110101111111011101
1010000010001000101000100010000000101000001000101
1010111111111110101110101111111111101011111110101
1010001000000010100000100000100010001000000000101
1011101011101110111011111110101011101011111111101
1000101000100010001010000010101000001010001000001
1110101110111011101110111010101111111010111011101
1000100000001000100010001010100000101010000000101
1011111111101110111011101010111110101011111111101
1010001000100010001010001000100000101010000000001
1010101010111111101010111111101111101010111111101
1000100010000000001010100010000010000010001000001
1111111111111111101010101011111010111111101011111
1000000000000000001000001000000010000000001000001
1111111111111111111111111111111111111111111111111
