1111111111111111111111111111111
1000100000100010000000000000101
1110101010101010111111111110101
1000101010001000100000000010101
1011101011111111111011101110101
1010001000000000001010100000101
1011101111111111101010111111101
1000101000100000001000001000001
1110111010101111111111101011101
1010001010001000100010001010001
1011101011111110101010111011101
1010001000000010101010101000101
1010111110111010101010101010101
1000100010100010001000100010101
1011101011101110111111111110101
1010001000100010000000000000101
1010111110101011111111111111101
1000100010101000100000100000001
1111101010101110111110101111111
1000101010101010000010001000001
1010111010101011111010111011101
1010000010101000001010100000101
1011101110101011101010111110101
1010001000100010101010000010101
1011111011111110101011111010101
1000000010001000101010001010101
1011111110101011101010101011101
1000000010101000001000101000101
1111111010101111111111101110101
1000000000100000000000001000001
1111111111111111111111111111111
