1111111111111111111111111111111
1010000000100010000000101000001
1011111010101010111110101011101
1000000010101010001000100010001
1111111110101011101011101110111
1010000010101000001010101010001
1010111010101111111010101011101
1010001000100000100010101010001
1011101111111110101110101010111
1000101000000000100010000010001
1011101010111111111011111111101
1000101010100010000000000000101
1010101011101011111111111110101
1010101000101010001000001000101
1110101110101010101010111011101
1000100010001000101010100010001
1011111011101111101110101111101
1000001000100000101000101000001
1011101110111110101011101010111
1010001000100010101000001010001
1010111011101110101011111111101
1010001010000000101000100000001
1111101011111110101110111011101
1000001000000010100010001000101
1011111111111011101011101010111
1010000000001000101010101010001
1010111111101110101010101011101
1010100000100010101010001010001
1010101110111010111010111110101
1000001000001000000010000000101
1111111111111111111111111111111
