1111111111111111111111111111111
1010000000100000100010000000101
1011111010101010101110111010101
1010001010101010100000100010001
1010101010111010101111101111111
1010100010000010101000100000001
1010111111111110111010111011101
1000100010000010001010001000101
1111101011101011101011101111101
1010001000101000100010100000001
1010101110111110111110111111101
1000101000000010000010000000101
1011101111111011111010111011101
1010100000101000000010001000001
1010111110101111111011101111111
1000101000100000000010101000001
1110101011111111101110101010111
1010001000000000100010101010001
1011101111111110111010101111101
1000001000000010001000101000001
1011111110111011101011101011101
1010000010001000101010001010101
1010111011101110101010111010101
1000100010000010101010100010101
1111101111111110101010111010101
1000001000000010101010000010001
1011111011111010101111111110111
1010000010001010101000000010101
1011111010101010101011111010101
1000000010100000100000001000001
1111111111111111111111111111111
