1111111111111111111111111111111
1000000010000000000010000000001
1111111010111111101010111111101
1000000010000010001010000000101
1011111111101110111011111111101
1010000000101000100010000000001
1010111110111011101110111111111
1010100010000010101000000000001
1010101011111110101011111111101
1010101010000000001000000010101
1010101110111111111111111010101
1010101000100000000000001000101
1010101011101111111111101110101
1000100010100010000000101000101
1111101110101010111110111011101
1010001000001000100010000010001
1010111011111111101111111110101
1000101000001000001000100000101
1011101111101110101010101111101
1010000000100010101010001000101
1011101111111010101011111010101
1010001000001000101000001010001
1010111011101110111111101011111
1010100010001000100000001010001
1010101110111011101111111010111
1010000010000000101000001010001
1011111111111111101011101011101
1010000000000010001000101000101
1010111111111010111010111110101
1000100000000000100010000000001
1111111111111111111111111111111
