1111111111111111111111111111111
1010001000000000100010000000001
1010101111111010101011111110101
1000100000100010001000000000101
1111111110101111111111111111101
1000000010101000000010000000101
1011111010101110101010111110101
1000001010100010101010001000101
1011101110111011101011101011101
1010100010001000101000101010001
1010111011101110101111101010111
1000001000100000101000101000101
1111111010111111101010101111101
1000000010001000100010101000001
1011111111101010101110101011101
1010000000000010100010101010001
1011111011111111111010101110111
1000001000100000001010100010001
1011101111101110111010111010101
1000100000101010001010000010101
1110111110101011101011111111101
1010100010001010001010000000001
1010111011111010111010111011101
1010001000000010001010001010001
1011101011111011101011111010111
1000101000001000101000000010001
1010101111101110101111111111101
1010101000100010100010000010001
1010101010111010111010101110111
1010000010000010001000100000001
1111111111111111111111111111111
