1111111111111111111111111111111111111111111111111
1000100000001000000010100000100000000000000000101
1110111011101011101010101010111111111110111110101
1010001010001010001010001010100000100000100010001
1011101110101010111011101010101110101111101111101
1000001000101010001000101010001000101000101000001
1011111011111011101110111011111011101010101011111
1000001000000010001010001000001010000010101000001
1111101011111110111011101111101010111110101111101
1000101010001000100000100000101010100000100000101
1010101010111011111110111110101011101111101010101
1010101010100010000000000010001010001000101010101
1010101010101110101110111111111010111011101011101
1010101000101010101000100000000010101000001000001
1110101011101010101110101111111110101011111111111
1000101010001000100010101000000000101000000000101
1010101110111111101011101111101111101111111110101
1010100010000000101000000000001000001000000010001
1011111010111110101111111111111110111010111111101
1000001010000010100010001000000010100010000010001
1010101011111010111010101011111010101111111010111
1010101000001010100010100010100010001000101000101
1010101111101010101110111110101110111010101111101
1010101000001010101010100000100010100010100000001
1010111011111110101010111010111010111010111011101
1010001010000000100010100010001010000010100010101
1011101011101111101110101111111011111110101110101
1000101000101000101000001000100010000000101000001
1110101110101110101011111010101110111110101110111
1010101000100010001010100010001000100010100010101
1010101011111010111010101110111111101010101010101
1000101000100010001000101000100000101010101010001
1111101110101011111110101110101110101010111011101
1000001010101010001000100010100010001010001000101
1011101010101110101011111011111011111011101010101
1010101010100000100010100010000010001010001010101
1010101010101111111110101110111110111010111110101
1010100010100010001000100000001000100010000000101
1010111010111010101010111111101010101111111111101
1010000010100000100010001000100010100000000000101
1010111110111110111111101010111011111110111110101
1010100010100010100000101010001010000010101000101
1011101010101010101110111011101110111010101011101
1010001010001010101010001010100010001010001000101
1010111011111011101011101010111011101011111110111
1010001010000010001000100010100010001000000010001
1011101010111110111011111110101110111111111011101
1000001000000000100000000000000000100000000000001
1111111111111111111111111111111111111111111111111
