1111111111111111111111111111111
1000100000100000001000001000101
1110111010101011101011101010101
1010001010001010001010100010101
1011101110111010111010111110101
1000100010100010100010000010101
1011111010101110101011101010101
1000001010101000101010001010101
1010101010101011111010111110101
1010101010101000000010000010001
1010101011101111111111111011101
1010101000101000000000000010101
1110101110101011111110111010101
1000100010001000100010100000101
1011111011111110101010101111101
1010001010001000101010101000001
1010101011101011111010111011111
1010101000001000000010001010001
1010101111101111101111101010111
1010100000001000001000001010001
1011111111111011111011111010101
1000001000000010000010000010101
1011101011111110111110111110101
1000100010000010001000100000101
1110111110111111101011111110101
1010100010000000101010000010101
1010101110111110101010111011101
1000100000100010100010100010001
1011111111101010111110101110101
1000000000001000000000100000101
1111111111111111111111111111111
