1111111111111111111111111111111
1000000010001000000000100010001
1111111010111010111110101010101
1000101010000010100010001010101
1010101011101110111011111011101
1010001000101000100000001000101
1011101110101011101111111110101
1000100010101010000000000010001
1010111010111010111111111011101
1010100010001010100010000000101
1010101111101010101010101111101
1010101000100010001010101000001
1110111010111111111010101011111
1000100010100000000010101010001
1011101110101111111110101010101
1000100010001000000000101000101
1110111011111011111110111111101
1000100010001010000010100010001
1011101110101010111011101010111
1010001000101000001010001000101
1010111011101111111010111111101
1010100000100010000010100000001
1010101111101010111110111011101
1010101000101010000010001010001
1010111010101111111011101010111
1010100010100000001000001010001
1010101110101110101111111110101
1010001010101000101000000010101
1011111010111011101011111011101
1000000000000010000010000000001
1111111111111111111111111111111
