1111111111111111111111111111111
1010001000000010000000001000001
1010101111101011111011101011101
1000100000101010001010101010001
1111111110101010101010101010101
1010000000101010100010101010101
1010111111101010111110101010101
1010100000101000100000101010101
1010111010101111111011101010111
1010000010001000000010001010001
1011111111111011101110111011101
1000001000001000101000100010001
1011101010111010111011111110101
1010100010001010001010000010101
1010111110101011101010111010111
1010100010101000101010001010001
1010101011101110101011101011101
1000101000100010101000001000101
1011101110101110101111111110101
1010001010101000100010100010101
1110111010101011101010101010101
1000100010001000101010101000101
1011101111101011101010101111101
1010000000001010001000101000101
1011111110111010111111101010101
1010000010101010000000100010001
1010111010101011111110111111101
1010100010001010000010000000101
1010101111111010111011111011101
1000100000000000100000001000001
1111111111111111111111111111111
