1111111111111111111111111111111111111111111111111
1010000010001000001000000000000000001000000000001
1011101110101010101111101111101111101010111111101
1010001000100010100000101000001000101010100010001
1010111011111110111110111011111010101010101011111
1010100010001000100010100010000010101010001000001
1010101111101011111010101110111110101111111011101
1010000000001010000010100010100010100000001010001
1011111111111010101110101010101010111111101110101
1000000000000010101000101010101010100000100000101
1111111111111111101011101011101010101110111111101
1000101000000000001000101010001000101000100000101
1010101010111111101110111010111111101010111011101
1010100010001000100010001010001000001010001010001
1010111111101010111011101010101011111011101010111
1010000000001010100010101010100010000010100010101
1011111111111010101110101011101110111110111010101
1000000010001010101000101000101000100000100010001
1111111010111010101011101110101011111011101111101
1000000010000010101000101000101000001000001000101
1011111110111110101110101011101111101011111010101
1010000010101000100000101000100000101000101010001
1010111010101011111110101110111111101110101011111
1010001010001000000010100010000010001010101000001
1011101011101111111010111011101010111010101111101
1010001010001000100010001000101010001000000000101
1010111011111010101010111110101010101111111111101
1010001010000010001010100000101010100000100010001
1011101010111111111010101111101010111110101010111
1000101010100010001010100010001010100010101010101
1010101010101011101010111010111010101110101010101
1010001010101000100010001010100010100010001010101
1011111010101110101111101011101110111011111010101
1000001010101010100000101000001010001010000010001
1110111010101010111111101111111011101010111111101
1010100010000010100000001000000010001010000000101
1010101111111010101111101010111010111011111110101
1000100000001010001000101010001010101000001010001
1011111111101111111010111011101110101010101011111
1000000010100000100010000010100000101010100010001
1111111010111110101111111110111111101010111010101
1000001000000010001000001010000000000010100010101
1010111111111011111011101010111111111010111010101
1010100000001010000010001000001000001010001010101
1011101011111010101110111111111011101111101010101
1000101000100010100010001000100010100000001010101
1010101110101111111011101010101110111111111011101
1010000010000000000010000010001000000000000000001
1111111111111111111111111111111111111111111111111
