1111111111111111111111111111111
1010001000000010000010000000001
1010101110101110111010111011111
1000101000101000001010101000001
1111101011101011111010101111101
1000001000101010100010001000101
1011111110111010101111101010101
1010000010000010100010001010001
1011101010111110111010111011101
1010001010000000101000100010001
1010111011111110101111101110111
1000101000000010101000101000101
1111101111111010101010101011101
1000001000100010100010101010001
1011101010101110111110101011101
1000100010101010000000101000101
1010111111101011111110101110101
1010100000001010000010101000001
1010101111111010111010101111101
1010001000000010001000100010001
1011111011101110111111111011111
1010000010101000100000001000001
1011111010101011101111101011101
1000001000100010001000101010101
1111101111111110111011101010101
1000100000001000100010001000101
1010111111101011101110111110101
1010100000101010000000100010101
1011101110101010111111101011101
1000000010000010000000001000001
1111111111111111111111111111111
