1111111111111111111111111111111111111111111111111
1000000010000000001000000000100000000000001010001
1111111011111011101110101111101111101111101010101
1010000010000010100010100000101000001000100010101
1010111110111110111010111110101011111011111010101
1010000000101000001010101000101000100000000010101
1011111111101010111010101011101110101111111110101
1000000000001010100010101000100010100010000010101
1011111111111010101110101110111010111110111010101
1000000000100010101000100010001010000000101010101
1011111110101110101011111010101011111111101010101
1000100010001000101000000010101000001000001000101
1011101011111010101111101110101111101011101111101
1010001010000010100000101000101000101010100000101
1110111010111111111110101011111010101010111011101
1000100000100000001000101010000010000010100010001
1011111111101110101011111010111111111110101110101
1010000000001000101010000010001000000010001000101
1010111111101011101011101011101011111010111011101
1010001000101010001010001010001010001010001010101
1011101010111010111010111010111011101011111010101
1000101010100010001010100010101000101000001010001
1010101010101111101010111110101110101111101010111
1010001010001000001010000010000010100000101010001
1011111011111111111011111010111110111011101011101
1010000010000000001000001000100010001000100010101
1010111110111111101111101111101011101010111110101
1010100000100000101000100000101000001010000010001
1010101111111110101010111110101111111110111010111
1010101000000010100010100000101000000010100010101
1110101011111010111110101111101011111010111110101
1000100010000010001000101000101000001010001000101
1011111110111110111011101010101011101011101011101
1000000010100000001000001010001000101000001010001
1111101010111011101111111011111110101111101011101
1000001010001010001000000010000010101010001000001
1011111011101110101011111110101110101010111111101
1010001010100010100010000010101000101010000000101
1011101010111010111110111010111011101010111111101
1000101000101010100000100010100010001000100000001
1010101110101010101110101110101110111011101111111
1010100010001010100010100000100010101010001000001
1110101011101010111010111111111010101010111011101
1000101000001010100010001000100010100010100010001
1011111011111010101111101010101110101110111010111
1010001000001000101000100010100010101000100010101
1010101111111111101010111110111010111011101110101
1000100000000000000010000010000010000000001000001
1111111111111111111111111111111111111111111111111
