1111111111111111111111111111111111111111111111111
1010001000100000000010100000001010000010001000001
1010101010111111101010101110101010101110101011101
1000100010100000001010001010100010100000101010101
1111111110101111111010111010111010111111101010101
1000000010001000001010000010001010100010001000101
1010111111111011101010111111101110101110111110101
1010100000000010100010100000100000100010000000101
1011101111111110111110101110111011111011111111101
1000001000001000100000101010001000000010001000101
1011111110111010101111101011101111111110101010101
1000000010000010000000101000001000000010101010001
1111111011111111111111101011111011111010101011101
1000000010000000001000001010000000001010101000101
1011111110111111101011111011111111101010101010101
1000100000100000100010000010001000101010101010101
1110101111111110111110111110101010101010101010101
1000101000000000001010000000100010001000101010101
1011101011101111101011111111111111111111101110101
1000001000100010100000101000001000000010100000101
1111111111111010111110101010111010111010111111101
1000000000100010000010100010000010100010000000101
1110111110101110111010111011111110101111101110101
1000100010001000001010001000100000101000001000101
1011111011111011101111101111101111101010111111101
1010000000100010100000100000100000100010100000001
1010101110101110111010111110101110111111101111111
1010101000101000100010100000100010100000001000101
1011101111101010101110101111111110101111111010101
1000100000001010100010100000000000100010000010001
1010101111111010111011111011111011111011101111101
1010100000001010100010001010001010001010001000101
1110111111101011101110101010101110101010111010101
1000100000101000100000100010101000100010100010101
1011101110101110111111111110101011111110101011101
1000101010100010000000000010100010000000101010001
1110101010111010111011101110111110101111101110111
1000101010001010100010101000100000101000100000101
1010101011101010101110101011111011101110101111101
1010100000101010101000001000001010001000100000001
1011101111101011101111101111101010111011111111101
1000101000001010001000100010001010001000000000101
1010101011111010111010111110111011101011111110101
1010101000100000100010001000100000101010001010101
1110101110111111101111101011101111101010101010101
1000101010001000101000001010001000001000101010001
1011101011101010101011111011111011111111101011111
1000000000100010001000000000000010000000000000001
1111111111111111111111111111111111111111111111111
