1111111111111111111111111111111
1000001000100000100000000000001
1111101010101010111011111111101
1000001010101010001000100000001
1011111010111011101110111111111
1000100010001010000010100000001
1110101011101011111010101111101
1000101000101000001010100010001
1011111110101011101010111010101
1000000000101000101010001010101
1111111111101110101011101010111
1000000010101000101000001010001
1011101010101011101111111011101
1000101000101000101000000000101
1110101110101110101011111011101
1010101000101000100010001010001
1010101111101011111110101110101
1000100010001010100000101000101
1011111010111010101111101011101
1000100010100010101000001010101
1110101110101110101110111010101
1010100000101000100010100010101
1010111111101110111010101110101
1000100000000010001010001000101
1011101111111010111011111110101
1000101000001010001010000000101
1110111011101011101011111011101
1000100010101000001000001000101
1011101110101111111111101010101
1000001000000000000000001010001
1111111111111111111111111111111
