1111111111111111111111111111111
1000000010000000000000001000101
1111111010111111111111101010101
1000001010100000000010001010101
1010101010101010111110111010101
1010101000101010100000100010101
1010101111111011101111111010101
1010100000001010001000000010101
1010111111101010111011111110101
1010000000100010000010000010001
1011111110111111111110111011101
1010001000100000000000101010101
1110101011101110111111101010101
1000100010001010001010000000101
1011111110111011101010111111101
1000000010100000101010001000101
1111111010101011101011101010101
1000000010101010001000001010001
1011111110101010111011111011111
1000100000001010001000100010001
1010101111111111101011101110111
1010000010000000001010001000001
1111111010111111101110111011101
1000100010100000101000100000101
1010111110101110111011111011101
1010000000101010001010001010001
1011111110101011101010101110101
1010000010100010101000101000101
1010111011111010101111101011101
1000001000000000100000000010001
1111111111111111111111111111111
