1111111111111111111111111111111
1000100000001000000000000000101
1110111110111011101111111110101
1010100010000010001000000000101
1010101010111110111111111011101
1010001010000010100010001000001
1011111011111010101010101111101
1000000010000010001000101000001
1011111111111011111111101011111
1000100000001010000010001010001
1110111110101010111010111010101
1000100000101010100010001010101
1011101111101110101111101110101
1010000000100010101000001000101
1011111110111010101110101011101
1000000000101000101000101000101
1111111111101111101011101011101
1000000000001000101010001010001
1011101110111010101011111010111
1000101000100010001010000010001
1011101011101111111010111111101
1010001010001000100000100000101
1110111010111010101111101011101
1000100010100010000000101010001
1011101110111111111110101110101
1010000010100000000010001000101
1010111110101111111011111011101
1010100010101000100010001010001
1011101010101011101110101010111
1000001000001000000000100010001
1111111111111111111111111111111
