1111111111111111111111111111111111111111111111111
1010001000000000000000000010000000100010000000001
1010101011111111101011111110101110101110111110111
1010100000000010101010001000100010101000100010001
1011111111111010101110101011111010101011111011101
1000100000001000100000101000001010001010000010001
1110101111101110111111101011111011101011101110101
1000101000101010001000100010000010001010001000101
1011101010101011101010111110111011111010111011101
1000001010101000101010001000101010000000100010001
1111111110101011101011101011101010111111101111111
1000000000101010001000101010000010101000100000001
1111101010101010111010111010111110101010111111101
1000101010101000001010001010100000101010000010001
1010111010101111101111101011101111101011111010101
1010000010100010000000001000101000001000100010101
1011111111111011111111101110101011101110111010101
1010000000001000100000100010000010101010001000101
1010111111101110101011111011111110101011101111101
1010100000100010101010000010001000000000100010001
1010101011111010101010111110101111111111111010111
1010101000001000101010001000100000100000000010101
1010101111101111101110111011111110101111111110101
1010100010001010000000100010000010101000000010001
1010111010101010111111101110101110101111101111101
1010100010100010001010001000101000001000100000001
1010101110101111101010111110101011111010111011111
1000101000101000001010100010100000100010001010001
1011101011111011111010101011111111101111101011101
1010001000001000001010001000000000101000101000001
1011111111101111101011111111111110101010101111111
1000000000101000001000001000001010100010100010001
1111111110101011111011101011101010111110111010101
1000001000100010000010000010100010000000001000101
1110101011101110111111111110111011111111101111101
1000101000101000100000100000000000100000101010001
1011111110101110101110111111111111101110101010101
1000100000100000100010000000000010001000100010101
1010101111111111101011111111111010111011111110101
1010100000100000101010000000101000101000000000101
1010111110101110101010111010101111101111111111101
1010000010001010101010100010000010000000001000001
1110101111111010111010101111111011101110111011111
1000101000000010001010100000001000001000100010001
1011111011101111101010111111101111111111101110101
1000100010100000101010000010001000001000001000101
1010101110111011101011111010111011101011111011101
1010000000001000000010000010000000100000000010001
1111111111111111111111111111111111111111111111111
