1111111111111111111111111111111
1010000000000010000010001000001
1010111111101010111010101010111
1010001000101010001010100010001
1011101011101011101110111111101
1000100010001000001000101000101
1110111010111110111011101010101
1010100010100000100010001010101
1010101110111110101110101010101
1010100010100010101000101010001
1010111010101011101110101011101
1010001010001000100010101000101
1011101011111110111010101110111
1000001000100010001010100010001
1011111110101011101011111011101
1010001010101000001000000010101
1010101010101111101111111010101
1000101000100000100010001000101
1111101111111010111110101110101
1000100000001010001000101000101
1010111111101011101011101011101
1010100000101010001010100010001
1011101011101110111010111110101
1000101000001000100010000010101
1010101111111011101111101010111
1010101010000000100000001010001
1110101010111110101111111111101
1000101000000010001000000000101
1011101111111111111011111110101
1000000000000000000010000000001
1111111111111111111111111111111
