1111111111111111111111111111111
1010001010001000000010000010001
1010101010101011101110111010101
1000101000100000100010101000101
1111101011111111111010101111101
1000001010000010001010001000101
1011111010101110101011101010101
1010001000101000100000101010101
1010101111101011111110101011101
1010100000101000000010101000101
1011111010101111111011101110101
1000100010100000001000000000101
1110101111101111111011111111101
1000100000001000001000100000001
1011111111111011101110101111101
1000001000000010100010101000101
1111101011111110111011101010101
1000001010000000001000101010101
1011111011111011101110101010101
1000100010001010100000001010001
1110111010101010111111111011111
1010001010101000000010001010001
1011101010101011111110101110101
1000001000101010000010100000101
1011111110101110111010111111101
1000000010100000001000001000001
1111111011111111111111101011101
1000001000100000100010001010101
1010111110101110101011111010101
1010000000001000001000000010001
1111111111111111111111111111111
