1111111111111111111111111111111
1000001000000000100000001000001
1111101111101011101110101010101
1000100000101000001000101010101
1010111110101111111011111010111
1010000010101000001000100010001
1010101110101110111110101111101
1010101000101000100000100010001
1110111011101010101111101110101
1000100010001010100000001000101
1011101110111011111111111011111
1000001010100010000000001010001
1011111010111010111111101010101
1000100010100010000000101000101
1110101110101111111011101111101
1010100000100000000010000000101
1010101111111111111110111110101
1010101000000000001000100010101
1010101111101111101011111010101
1000101000001010001010000010101
1011101011111010111010111110101
1010000010000000000010000000101
1011111110111111111011111111101
1000100010100010001010000000001
1110101011101010101110111111101
1010001000001010100010100000101
1011111111111010111010111110101
1000000000100010100010001000101
1011111111101110101111101011101
1000000000000000100000001000001
1111111111111111111111111111111
