1111111111111111111111111111111111111111111111111
1000100000000000101000001000100000000000100010001
1110101111101110101011101010101111101110101010101
1010101000001000001000100010001000100010001000101
1010101011101111111110111111111010111011111111101
1000101010001000100010000010000010001010100000101
1011111011111010101011111011111110101010101110101
1000001000000010001010001000000010101010001000101
1111101110111111111010101111111011101011111011101
1000100010000000100010100000100010001010001000001
1010111011111111101110101110101110101010101111111
1010001000100000100000101010100000101000100000001
1011101110101110111011101010111111101111111111101
1010001000100010001010001000100010001010001000001
1010111011101011101110111011111010111010101011101
1010000010101000100000101010000010001010100010001
1011111110101110111111101010111011101010111111101
1000100000001010000000101000100000101010001000101
1110111111101011111110101011111111101011101010101
1010001000100010000010100010000000001000100010101
1011101010111010111110101110111111111010111110111
1000100010101000100000101000100000001010001010001
1011111110101110101110111011111110101011101011101
1000000010100010100010100010000000100010001000101
1011101110101110111010101110111111111110111011101
1000100000100000101010100000100010000010100010001
1110111111101111101011111111111010101110101110101
1000100010001000001000000010000010100010100010101
1011101010111010111111101110101110111010111010101
1000101010000010100010001000100000101000100010101
1110101011101111101010111011111111101111101010111
1010101010001000001010000000001000000000001010001
1010101011111011111011111111101111101110111011101
1000101000000010001010001000100000100010100010001
1011101111111111101010101010111110111010101110111
1010001000000000001010101010001000100010100010001
1010111011111111111010101110101011111010111111101
1000101000000000001000100010101000001010000000101
1111101011111111101111111010101111101111111011101
1010000010000000100000001010100000100010001010001
1010111110101011111111101011101111111010101010101
1010100010101010000000001000100010000010101010101
1010101110101010111111101110111010111110101010101
1000100000101010000010001010001000000000100010101
1011111011101011111010111011101111111011111010101
1000001000101010100010000000100010001010001010101
1111101111101010101111111111111010101110101110101
1000000000001000100000000000000000100000100000101
1111111111111111111111111111111111111111111111111
