1111111111111111111111111111111
1010000000000000100010001000001
1011111011111010101010101011101
1000001010001010001000101010001
1111101010101111111111101010111
1000101010100010000000100010001
1011101010111010111110111011101
1010001010101000100010001010001
1010111110101111101011101110111
1010001000100000001000100010001
1011101011111111101110111011101
1000001000000010001000100010001
1011111011111010111111101110101
1000001000001010000000000000101
1111101111101011111111111111101
1000101000101000000010000010001
1110101010111011111010111010111
1000100010001000001000100010101
1011111111101111111111101110101
1000001000100000001000100010001
1011101010111111101010111011101
1010001010000010101010000010101
1010101010111010101011111110101
1010101010101010101000001000001
1110101010101010101110101110111
1000101010100000100010100010001
1011101010111111111010111011101
1000101010000000000010001000101
1010111011111111111111111110101
1010000000000000000000000000101
1111111111111111111111111111111
