1111111111111111111111111111111111111111111111111
1000000000100010000000000010100000001000001000001
1111111110101010101111111010101110111010101011101
1000100010001010100010000010000010100010100010101
1010111011111010111011101110111110101110111110101
1010100010001010001000100010100000100010100000101
1010101010111011101110111011101111111010101110101
1010001000100010101010100000100010000010100010101
1011111111101110101010111110101010111110111011101
1000001000001000000010000010101000001000100010001
1011101011111111111011111010111111101011101010111
1000101000000000100000100010000010001010001010101
1111101111111110101111101111111011111010111110101
1000000000100000101000001000001000001010000010101
1010111111101111111011111011111111101011101010101
1010100000100010000010001000000010001000101010001
1011101110111010111110101011111010111110101011101
1010001010001000100000101010000010000000101010001
1010111011101111111110101010111111111111101010111
1000100010000010000000101010100000000000101000101
1011111010111010111111101110101111101110101111101
1000000010001010000010001000101000101010101000101
1011111111101011111010111010101011101010101010101
1010001000001010000010100010100010001000101010101
1110101011111010111110101110101110111011101010101
1000101000001000101000101000101000100000101010001
1011101111101111101011101111101011111111101011101
1000100000100000101000001000101000001000001000101
1010111110111010101111101010101111101011111110101
1010100000001010100010001010101000100010000000101
1110111111101110101110111010101011111110111111101
1000100000101000100000101010001000100010000000101
1011101110101011101111101011111010101010111110101
1010000010100010001000001010001010101000100010101
1010111110111111101110101010101010101111111010111
1000100000100000100000101010101010100000001010001
1111101110101110111111111011101010111111101011101
1000001000101010000010001000100010000010000000101
1011111011101011111010101110111110111010111111101
1000100010001000100010100010000010001000100000001
1110111110111010101110101111111011101111101111111
1000100010000010100010100000000010001000100000001
1011101011111110111010111111111111101110111111101
1000101000000010101010100000000000100010000010001
1110101110111110101010111111101110111010111010111
1000101000100000101010000000001010100000100010001
1011101011101111101011111111111010111111111111101
1000001000000000001000000000000000000000000000001
1111111111111111111111111111111111111111111111111
