1111111111111111111111111111111111111111111111111
1010000000000000100010000010000000000000100000101
1011101111111110111010101011101111111110101010101
1000101000000010001000101000101000100000101010001
1110101011111011101011101110101110101111111011111
1010001000001010001000100010100010000000001000001
1011111011101010111110111010111011111111101011101
1000001010001010000010100010001000001000001010001
1011111010101111111011101111101111101011111110111
1000000010101000001000100000101000001010000010001
1011111110111011101110101110101011111011101011101
1000100010001010001000101000101010001000001010001
1110101011101010111011111011101010101111111010111
1000101000100010001000001000100010101000100010001
1011111110111111101111101110111110111010101111101
1010000010000000100010101000100010001010001000001
1010111011111110101010101011101011101011111010111
1000101000001000101010100010001010001010001010001
1111101111101010101010111111101010111010101011101
1000000010101010101010000000001000100010101010001
1011111010101011101011111110101111101110101110101
1010000000101000101000000010101000001000100010101
1011101111101010101111111010111011111011111010101
1000101000101010100000001010100010001000001000101
1010101010101110111111101010101110101011101111101
1010101010101000100000101000100010100010001000001
1110111010101011101011101110111010111110111111101
1000100010001010001000101000100010001010001000101
1010101111111010111110101111101111101011101010111
1010101000100000001000100000001000101000100010001
1011101010111011111010111111111011101011111111101
1000100010001000100010000010100000000010000000101
1010111111101111101111111010101111111010111110101
1010000000100000101000000000101000001010101000101
1011111011111110101110111111101011101110101011101
1000001000100010100010100000101010000000101000101
1110111110101010101011101110101011111111101110101
1000100010001010101000000010001000001000001010101
1011101011111010101111111111111011101010101010101
1000101000100010100010001000001000101010100010001
1111101110101110111011101011101111101010111111101
1000001010101000100000001010001000001010000000001
1011111010101011111111111010111011111011111111111
1010001010001000100010001010100010001000000010001
1010101011101110101010101010101110101111111010101
1010101000000010001000100010100010100010000010101
1010101111111111111111111110111010111110111110101
1000100000000000000000000000000010000000000000101
1111111111111111111111111111111111111111111111111
