1111111111111111111111111111111111111111111111111
1000001000000000000000100010100000001000100000001
1111101010111111111110101010101110101110101111101
1000101010000000100010101000101000100000101000001
1011101111111110101010101111101011111111101011101
1000001000000000101000101000001000000000101010001
1011111011111111101111101011111111111110101011101
1010000000100000001000001000100010000010001000101
1010111110101111111111101110101010111111101110111
1010101000100010000000101000101010001000100010001
1010101011111010111110101011101011101010111111101
1010001010000010001000100010001000001010000000101
1011111010111111101011111011101111101011111110101
1000100010001000101010001000001000101000001000001
1110101111101010101010101111111110101111101111101
1010100000100010001000101000001000101000100000101
1010101110111111111111101011101010101010111110101
1000100010100000000010100010101010101010001000101
1011101110101011111010111110101011101110111011101
1010001000101000101010000010001000100000100010101
1010111011111110101010111010111010111110101110101
1010101000000010100010001010100010000000101010001
1010101111111010101111101010111111111110101010111
1010001000000010100000101010000000000010101000001
1011101011111110111110111011111111111011101111101
1000101010000010100000000000000000001000100000101
1110101010111010101111111011111111101110111110111
1000101010100010101000100010000010000010000010001
1011101010101110111010101110111011111111111011101
1000101010100000100010100010001000100000001000101
1110101010111110101110111111101110101110101110101
1010101010000010100010000000001010001010100010101
1010101010111010111011111111111011111010111010101
1000101010100010101000000000001000001010001010101
1011111010101110101111111111101110101011101110101
1000000010100010001000000010001000101000101000101
1111111110111011101010111110111011101011101011101
1000000010101010000010100000100010000010001010001
1110111010101011111111101111101110111110101011101
1000100010001000100000001000001010001000101000101
1011111110111110101111111111101011101011111110101
1000100000100010100010000000101000101000000010101
1010101111101010111011111010101110101111111010101
1010100010001000100010000010101000101000101010001
1110101110111111101110111110101011101010101011101
1000101000100000100010100000101000101010001000001
1011101011101110111010101111101010101011101111111
1000001000000010000000100000001010000010000000001
1111111111111111111111111111111111111111111111111
