1111111111111111111111111111111111111111111111111
1010100000101000100000001000001000000010000000001
1010101010101010101011101011101011101011101111101
1010101010100010001010000010001010101000101000001
1010101010111011111011111111111010101110101011111
1010101010001010000010000000000000101000101000001
1010101011101010111110111111111111101011101111101
1010001010001010000000100000001000001000100000101
1010111010111011111111101110111011111110101111101
1010100010100010000000001000100010000010101000001
1011101110101111111111111010101110111010111011101
1010001010100000000010000010100010100010100010001
1010111010111111111010111110111010101110101110111
1000100000100000000000101000001000101010001010001
1111101111101111111111101011111111101011111011101
1010001000100010000000100010000000001010000000001
1010111110111010111110111110111111111010111111111
1010100000100010000010001000100000000000000010001
1010101010101111111011101011111111111111111110101
1010101010100010100010001010000000100000000000101
1010101011111010101110111010111110101111111111101
1000101010000010100010001000100000100010001000001
1011101010111110111011101011101110111011101011101
1000101010000010001010001000100010001000001010001
1110111011111010101011101111111011111111101010111
1000100010000000101000100000001000001000101010101
1011101110111111111110111111101110101010101010101
1010000000001000000000100000100010100010001010101
1011101111111011111111111011111010111111111010101
1000101000000010000010000010000010100000000010101
1110101011111110111010101110111111101111111110101
1010101000000000001010100010000010001000000010001
1010111110111111111010111011111010111011111111101
1010000010001000000010100000101010001010000010001
1011111011111011101111101110101011101010111010111
1000001000001010001000100010001010001010101010101
1110111111101011101010111011101010111010101010101
1000100000101000101010001010101000100010101000101
1011101110101110111011101010101111111010101111101
1010001000100010000010001010001000000010001000001
1010111011111010111110111011111010111011101111101
1010001000000010001000100010000010001000101000001
1011101111111111111011101010111111101110101011101
1000001000000000001000101010001000101000101010001
1011111111101111101010101011101010101110101011101
1000100000100010001010101000101010100010101000101
1110101110111010111110101110101110111011101110101
1000001000000010000000100010000000001000000000101
1111111111111111111111111111111111111111111111111
