1111111111111111111111111111111
1000001000000000100000100000001
1111101011111110111010111110111
1010001010000010100010100010001
1010111010111110101110101011101
1000100010000010101000101000101
1011101010111010101011101110101
1010001010001010001010000010001
1011101011101011111011101011101
1000101000101000001000101000101
1110111110101111101110101110101
1010000000100010001000101000101
1011111111111010101011111011101
1000001000001010101000001000101
1010111010111010111111101110101
1010000010000010000010001000101
1011111111111111111010111011101
1010100000100000001010100010101
1010101010111110101010101110101
1010001010000000101010101000001
1011101011111111101010101111111
1000101000000010101000100000001
1110111011111010101111111111101
1010001010001010101000000000101
1011101110101010101110111110101
1000100000100010100010001010101
1011111111111110111010101010101
1010000010000000001010101010001
1010111010111111101011101011101
1000001000000000100000001000001
1111111111111111111111111111111
