1111111111111111111111111111111111111111111111111
1010000000001000100000100000100000000010000010001
1011111110101010101011101011101110111011111010101
1000100000100010101010001000001000101010001000101
1110101111111110101110111111111011101010101111101
1010100010001000101000000000100010001000101000101
1010101010111011101011111111101110101111101010101
1010101010001000100010000000001000100000000010001
1010101011101110101110101111111111111111111111101
1000101000101000100010101000000000001000100000001
1011111110101011111010101011111111101010111110111
1010000010100000100010101010000000100010000010001
1011101010111110111110111010111111101111111011101
1010001010001000100010000010001000100000101000101
1010111011101011101010111111101010111110101110101
1010101010001000001010000010001010000010001000101
1010101010111111111011111010111011111011111011101
1000100010000010001000001000100010000010000010101
1111101111111010111111101111101111101110111110101
1000101000000010000000000000100000101010001000101
1010101110101111111111111110111110101010101011101
1010100010101000000000001000100000101010101000001
1011111010111011111111101011101111101010101111101
1000001010000010000000101010001010001010101000101
1111101010111111101110101011101010111010101010111
1000001010100000001000101010001010100000100010001
1011111010101011111011101010111010111110111111101
1010000010101000100010101000101000100010101000101
1010111110101110101110101111101011101010101010101
1000101000100010101000100010000000101010001010001
1011101011111110101110111011111110101011101011101
1000100010000010100000001010000010001000101010001
1110101110101010111111101010111011111110101011111
1010101000101010100010001010101000100010101000001
1010101111101010101011111010101110111010111111101
1000100000001000101000000010001010001010000000101
1011111111111110101111111111101011101011111110101
1000000010000000100000000000101010001000000010001
1111111010111111111111111110101010111011101111101
1000100010000000000000100000101010001010001000101
1011101111111111111011101011101011101010111010101
1000001000000000100010001010001000101010100010101
1011111011111110111110111110111110101110101110101
1010000010100010000010000000000000100010101010001
1011111010101011111011111111111111101010101011111
1000000010001000001010000010001000101010101000001
1111111110111111101010111010101010111010101111101
1000000000000000100000100000100010000010000000001
1111111111111111111111111111111111111111111111111
