1111111111111111111111111111111111111111111111111
1010001000000000001000001000000010000000001000001
1010101011111110111010101011111110111010111010101
1010101010001010000010100010001000100010100010101
1011101010101011111110111110101011101110101110111
1010001010100000001000100000100000101010100010001
1010111010111111101011101111111011101010111011101
1010000000100010001000001000001010001000001000101
1011111111101010111111111011101110111111101110101
1000000010001010001000001000100010000010000010101
1111111010111011111011101110111011111011111110101
1000000010101010000010001000101000001000000000101
1011111110101010111110111011101111101011111011101
1010000000101000100010100010000010001010001000101
1011101011101111101110101110111110111110101111101
1000101010000010000000101010000010000000100000001
1110101010111110111111101010111011111111111111101
1010101010100000100000001010001000000010000010001
1010111010101111101011111011101011101110101110111
1010001010101000101000100010001010001000100010001
1011101010101010111110111010111010111011111011101
1000100010100010000010001010001010100000100000101
1010111110111111111011101011101011101111101111101
1010000010001000001010001010001000101000100000001
1110111010111010101010111010111110101010111111101
1000100010000010101010001000000010101010001000101
1011111010111110111011101111111110101011101010111
1000001010100010001000100010000010001010100010001
1111101011101011101110101010111011111010111111101
1000001000001000000010101000001000100010001000101
1011101111111111111010111111101110101110111010101
1010101000001000001010000010101010001000001010001
1010101011101010111011111010101011111111101011101
1010001010001010000010001010000000000000001000101
1011111010111111101110101010111111111111101110111
1000000010000000100010100010100000001000000010001
1011111111111110111010111110101111101110111111101
1010000000001000100010001010100010100010001000101
1010111111111011111111101010111010111010111010101
1010001000000010000000101000100010001010100010101
1011101011111110111011101011101110101010101110101
1000101000100000101000001000100010101010101010001
1110101110101111101111111111101010101010101011101
1010001000101000000000100000101010101010101010001
1011101011101110111110101110111010101011101010111
1000101000001000100010101010100010100010001010101
1010101111111011101110101010101110111110111010101
1010000000000010000000001000001000000000100000001
1111111111111111111111111111111111111111111111111
