1111111111111111111111111111111
1010000000100000000000000010001
1010111010111111111110111011101
1010001010000000000000101000101
1010111011111111111111101110101
1010100010001000001000000010001
1011101110111011101011101111101
1010001010001000100010100000001
1010111010101110111110111111111
1000100010100000100010001000001
1111101110111111101010101011101
1000100010001000001000100010101
1010101011101110111111111110101
1010101000100000101000001000101
1010111010111111101010111010101
1010001010001000100010100010001
1011101011111010101110101111111
1000101010000010101000101000001
1110101010111110101011101011101
1000100010000010001010001000101
1011111111101111111010111110101
1000000000001000000010100010101
1011111111101010111110101110101
1000100000101010100010100000101
1110101110111010101010101111101
1000101000100010101000100010001
1011101011101110101111111010101
1000101000001000101000001010101
1110101111111111101110101110101
1000100000000000000000100000101
1111111111111111111111111111111
