1111111111111111111111111111111111111111111111111
1000000010000000100000000000100000000000100000001
1111111010101110101110111110111111101011101111101
1000001010101010100010100010000000101000100010001
1010101011101010111010101011111110101110111010111
1010101000001010101010101010000010100010000010001
1010111111111010101010101011101110111011111111101
1010001000000010100010001000101000100010000010001
1111101011101110111111101110101011101110101110101
1000101000100010000000101000101000100000101000101
1010101110111011111110111011101110111111111011101
1010000010101000000010000010000010001000000010101
1011111010101111101111111110111111101011111110101
1000001010101000001000100000000000001000001000101
1011101110101011111010101111111111111111101011101
1010100010001010001010101000001000001000001010001
1010111011101010101010101011101110101011111010111
1000001000101000100010001000100010101000101000101
1111101110101111111111111110111010101110101011101
1000101000101000100000000000100000100000101000001
1010101010101010101111101011111111111111101111101
1010101010101010001000101000001000000000001000001
1011101010101110111010111111101011111111111011111
1010001010100010100010001000001010000000100010001
1010111011111010101111101011111010111110101111101
1010001000000010100000100010100000100010100000001
1011101111111111111110111110101111101110111111101
1010001000000000100000100000101000001000100000101
1010111011111110101111101011101011111011101110101
1000100000000010001000001000100010001000100010001
1011111011111011111111101110101110101010111011111
1000001000001000100000100010001000101010001010001
1111101111111110101110111011111011101111101010111
1010001000000010001000101000001010000000001010001
1010111011111011111011101111101011101111111011101
1000100010001000100010001000001000101000000010001
1011111010101110101110101011111110101011111110101
1010000010100010101000101000001000101000000000101
1010111110111110101010111111101010111111111111101
1010001000100000101010100000101010100000000000101
1011101010101111101110101110101011101111111010101
1000001010101000101000101010101000100000001010101
1111111110101010101011101010101110111111101011101
1000000000100010001010000010101010000010001010001
1111101111111111111010111110101010111010111010111
1000001000000000001000101000100010001010101000101
1011111011101111111011101011111011101110101111101
1000000000100000000000001000000000100000000000001
1111111111111111111111111111111111111111111111111
