1111111111111111111111111111111111111111111111111
1000001000100000000000100000000000100010000010001
1111101010101011111110101111111110101011101010101
1000001010001010000000100000100010001000101010101
1011111111111011111110111110101011111110101010111
1010000000001000000010100010001010100010001010001
1011111011101110111010101011111010101011111011101
1000001000100010100010001010001010001000001000001
1111101110111011101111111010101010111011101111101
1000100000101000101000001010100010001000100000101
1010111111101110101010101010111111101110111111101
1010000000000010001010101000100000100010100010001
1011111011111011111010101111111010111110101010111
1010001010000000100010101000000010100000101000101
1011101011111110111110101010111110101110101111101
1000001010000010000010101010000010001010101000001
1011111010111011111010101011111011111010101010101
1010000010001000100000101000001000001000101010101
1010111011101110111011111111101111101011101010111
1010101010101010001010000000101000001000101010001
1110101010101011101110111011101011111110101011101
1000100000101000101000101000101010000010101000101
1010111111101010101011101110101011101010101110101
1010100000001010101000100010101000101000101010101
1011101111111010101110111010101110101111101010101
1010001000000010100010000010000010101010001000101
1010111111101111101111111011111110101010111011101
1010100000100000100000000000100000100010101000101
1010111010101110111110111111101111111010101011101
1010100010100010100010100000001000001010101010001
1010101110111010101011101011111011101110101010101
1000101000101010101000001010001010101000101010101
1011101011101010101011111110101010101011101010111
1010001010000010101010000000100010101010100010001
1011101011111110101110111111111110101010101111101
1000101000000000101000100000000000100010101000101
1110101111111110101011111011111110111110101010101
1010101000001000101010000010000010000010001010101
1010101010111011101010111110101111111010111010101
1010101010000010001010001000101000001010100010101
1010101011111110111011101011111010111010101110101
1010001010000010001000101000100010000010100010001
1011111010101011101110101110101111111111111011111
1000001010101000100000100010001000000000001000001
1011111010101110111111111010111111101111101111101
1000100010100010100000000010100010001000101000001
1010101111111010111111101110101010111011101011101
1010000000000010000000001000001000100000000010001
1111111111111111111111111111111111111111111111111
