1111111111111111111111111111111
1000100000001000000010000000101
1110101110101110111010111110101
1010101000100000100010000010101
1010101011111111101110111010101
1000101000100000101000100010001
1011111110101110101111101111111
1010000010100010100000100000001
1011101010111011111110101111101
1010001010001000001000100000101
1010111010101111101011111011101
1000100010100000101010000010001
1111101111111110101011111110111
1000001000000000101010000010001
1011111011111111101010111011101
1000100010100000100010101000101
1110111010101011101110101110101
1000100010101010001000100000101
1011101110101010111011101111101
1000100010101000100010101000101
1110101010101111101110101010101
1010101010100010001000100010101
1010101010111010111110111110101
1010101010001000100000100000101
1010111010101111101111101111101
1010001010100010000000001000001
1011101010101010111111111011101
1000101010101010100010000000101
1010101010101110101011111111101
1010000010100000001000000000001
1111111111111111111111111111111
