1111111111111111111111111111111111111111111111111
1010000000001000000000100000100000000000000010001
1011111010101110111110101110111111101111111010101
1010001010100000101000100010000000001000001000101
1010101110111111101011111011111111111010111111101
1000100010100000001010000010000000001010000010001
1111111010111011101010101110111111111011111010111
1000001000100010001010101000000010000010000010101
1011101111101111111011101011111010111110111010101
1000101000100000001010001000001010001010001010101
1111101010101111101010111111111011101011101010101
1000001010100010001000100000000010101000101010101
1011111010101110111111111011111010101010101110101
1000100010001000100000000010000010100010100010101
1010101111111011101110101111111010111110111010101
1010001000001000001010101000001000100000100010101
1011111011111111111010111011101111101111101110101
1010100000000000000010001000100000001000100000101
1010101111111111111011101110111111111010111111101
1010101000001000100000100010100010100010100000101
1010101011101110101110111010101010101010111010101
1010000010100000100010101000101010001010001010001
1010111110111011111010101111101010111011101011101
1010100010000010000010100000001010100010101010101
1011101011111110111110101111111011101110101010101
1010001000000000101000101000100010001000100010101
1010111111111111101011101110101110111010111110101
1000101000000000001010001000101000100010001000101
1111101011101111111010101011101011101110111010101
1000001000100000100010101000001000100010001010101
1110111011111110101110101011111110111011101010101
1000100010000000101000101010000010100010100010001
1011101110111111101011101010111010101110111111111
1000000010100000001000101000101000101000000010001
1111111110101111111110101111101111101011111011101
1000000000101000000010100000100010001000100010001
1011111011101011101110111110101010111110111010101
1000001010001010100000001000101010000010001010101
1011101010111010111111101011111011111011101010111
1010001010100000001000101000100000100010001010001
1010111110101111111010111110101011101110111011101
1010100000101000000010000010101010001000101000001
1110101111111011111111111010101110111011101111101
1000101000000010100010001000100000100010000000001
1011101010111110101010101111101111101110111111111
1010001010100000001010100000100000101010000010001
1010111110101111111010111011111110101011111010101
1000000000100000001000001000000000001000000000101
1111111111111111111111111111111111111111111111111
