1111111111111111111111111111111111111111111111111
1010001000000000100000001000000010000010001000001
1010101011101110101011111010111010101010101011101
1000101000100010101000000010001010101000101010001
1111101111111010101111111111101011101110111010101
1010001000000010100010001000101000101000100010101
1010111011111110111110101010101110101111101110111
1010100010001010001000100010100010100000101010001
1010101110101011101011111110111010101110101011101
1000100010100010001000000010000010100010001000101
1011101010111010111111101011111110111011111011101
1010001010001010001000101000100000100010000010001
1011111011101111101010111110101111101110101110101
1000001000100000001010000000101000000000101000101
1111101110101111111011111111101111111111101011101
1000100010100010000010000000100000101000001000101
1010111010111011101111111010111110101011111110101
1010001000100010001000001010100010101010000010101
1110101111101110111011101011101010101011111010111
1000100000101000100010101000101000101000100010001
1011111111101011101010101110101111101110101011101
1010000010001010001010000000101000100010101000101
1010111010111010111011111110101010101110101111101
1010001010100010101000000010100010101000100010001
1011101010101110101111111011111110101011111010111
1000101010101010101000001000000000101010000010001
1011101010101010101010111111111111101010101111101
1000001000101000100010001000000010000000101000001
1011111111101011111011101010111010111111111011101
1010000000001010001000100010101010000010001010001
1011111011111010101111111110101011101110101011111
1000100010000010100000000000100010001000101000001
1110101111111010111111111111101111111011101111101
1000101000001000100000100000001000001010100000001
1011101011101111101110101111111110101010111111101
1010100010001000101010100010000010100010000010101
1010101110111110101010111010111010111110111010101
1010001000100000101010001000100010000010001000101
1010111011101110101011101111101111101011101111101
1010100010001000101010001010001000101000100000101
1010101110111011101010101010111010101110101110101
1010101010001010000010100010100010101000100010001
1011101010101110111110101110111010111011111011111
1010001000100010101000101000100010001010001000001
1010111011111010101011111011101111101010101111101
1010001010001010101000001000101000101010100010001
1011101010101010101111101110101010101010101110111
1000001000101000000000100000001010000010100000001
1111111111111111111111111111111111111111111111111
