1111111111111111111111111111111111111111111111111
1010001000001000000000100010000000100000001000101
1011101011101010111111101010101111101110101010101
1000101000101010100000001000100000000010100010001
1110101110101010101111101111111111111110111011111
1010100000100010001000100010000000100000100010001
1010111111111111111010111010111110101111111110101
1010000010000000000010101000100010100000000000101
1011111010101111111110101111111010111111111111101
1000001010101000100000100000000010000000000000101
1011111010111010111011101011111111101111111111101
1000000010000010001000101000000000101000000000101
1011111110111111101110101111111110101011111110101
1000000010100010001000100000100010001010001000001
1111111011101010111011111110111011111010101111101
1000001000101010101010000010001000100010100010001
1011101110101010101010111011101110101110111010111
1000100010001000101010101000101000100010100010001
1110111011111111101010101011101010111010101111101
1000100010100000101010101000001010001000100000101
1011101110101010101010101111111011101111111110111
1010000000101010001010001000001000100000000010001
1011111110101011111011101011101010111111111111101
1000100000101000001010000010001010001000000000001
1010111111101111101011111110111011101011111111101
1010000010000000101000000010001000101000000010101
1111111010111111101111111011101111101111111010101
1000001000100000100010001010000000100000001010001
1011101111101110101011101011111110111110101011111
1010000000001010101000001000000010000000101000001
1011111111111010101011111111111011111111101111101
1010000000100000001010000000100010000010001000001
1010111110101111111010111110101110111011111011101
1010001010101000100010001010001000001000000010101
1011101010111010101111101011111111101111111110101
1000100010000010100000101000000000101010000000101
1010111011111110111110101111111010101010111110101
1010001010000010100000100000000010001010100010101
1110101011111010111110111111111111111010101110101
1000101010001010000010000010000010100000100010001
1010111010101011111011111010111010101111111011111
1010100010100000100010001010101010100010000000101
1010101110111011101110101010101010111010111110101
1010100010001010001000101000100000100010001010001
1011111010101110101011101111111111101111101011101
1000000010101000101010001000001000100010001000101
1011111111101011111010111011101010111010111010101
1000000000001000000010000000100010000000100010001
1111111111111111111111111111111111111111111111111
