1111111111111111111111111111111111111111111111111
1000000010000010000000100000001000000000000000001
1111111010111010111110101111101010111111111111101
1010000010001000101000101000100010000010001000101
1010111111101111101011101011111111111010101011101
1000100000101000001010101010000000001000101000001
1011101110101010101010101010101111101111101011111
1000001010001010101010101000101000100010001000101
1111111011111010111010101110101010101110111110101
1000001000000010001010000010100010101000100000101
1011111011111111101011111010111110111011101111101
1000001000001000001000100010000010100010101000001
1011101110111011101110101111111110101110101110101
1010100000100010001010100000000010101000100010101
1010111111101110111010111111111010101010111010111
1010000000101000000010000010000000101010100010001
1011111110101111111111111011111110101110101111101
1000000000100010000000001000001000101000101000001
1111111110111010111110101111101111101011101110101
1010000000100010100010101000101000101000101000101
1010111111101010101110111010101010101110101011101
1000100010001010100010100010001010101000101000101
1011101010111010111010101111111010101011101110101
1010101010100010000010001000000010001010001000101
1010101010111111111011111110101111111010111011111
1010001010000000001010000010101000000010100010001
1011101011111111101010111011101011111110101110101
1000101010000000100010100010001000100000100000101
1110111010111010111110111010111010101111101111101
1010001010001010100010001000100010100000100010001
1011101011101010101010101111101110111110101110101
1000101000001010101000101000101010000010101000101
1110101110111010101111101010101011101110111011101
1000100010100010101000101010100010100010000010101
1010111010101111101010101110111010111011111110101
1010001010100000000010101000001010001000100000101
1011111010111111111111101011111010101110101010101
1000000010100000100000001000000010101000101010101
1011111110111010101111111011111110111011101011101
1000001000100010101000001010000010001010001000001
1111101110101011101110101011111010101010111111111
1000100010001010001000101010001000101000100000101
1010111011111010111011111010101011101111101110101
1010001010000010100000001000101000100000001010101
1011101011111010101111101111101110111011111010101
1010100010001010100010001000101000001010000010101
1010111110101110111010111010101111111010101110101
1000000000100000100010000010000000000010100000001
1111111111111111111111111111111111111111111111111
