1111111111111111111111111111111111111111111111111
1010000010000000000000000010000000000000100000001
1010111011111011111111111011111111101110111110101
1010100010001000001000001000100000101000000000101
1010101110101111101011111110101110101111111111101
1000101000100010001000000010001010101000101000101
1111101011111010111011101011111010101010101010101
1000001000101010100000101000001000100010101010001
1011111010101010101111101110111011111110101011111
1010001010100000101000101000100010001000100010001
1010111010111111111010101011101110101011101110101
1010000010001010000010001000100000100010101000101
1011111111101010101111111110111111111110101110101
1000100000001010100000000010000000001000001000101
1110101111111010111111111010111111111011111011101
1000101010001000100000001010100000100010000010001
1011101010101011111111101011101110101110111011101
1010001000101010000000001000001010001000101000101
1010111011101010101111101111111011111011101110101
1000101010001010101000100000100010001010001000101
1111101010111011101010111110101110101011101011111
1000100010001000001010000010100010100000001000001
1010101111101111111011111110101010111111111011101
1010100000100000001000100000101010000010001000101
1011111110111111101010101111101011101110101110101
1010000010001000100010101000001010001000100010101
1010111011101010111110101111111010111011111011101
1010100000101010000000100010000010001010001010001
1010101111101011111011111010111011101010111010111
1000101000001010001010001010100010001010000010001
1011101011111010101110101010101110111011111011101
1010001010001010100000100010100010101000001000101
1010111010101010111111111110111010101111101110101
1010001000101010100000000010001010001000100010101
1011101110111010101111111110101111101010111010101
1000100000100010100000000000100000101010001010001
1110111111101010101111111111111011101011101011111
1000000010001010100010001000001000001010001000001
1011111110111010111010101011101111111110101111101
1000100010100010001000100010001000000000100000101
1111101010101111101111111110111011111111111011101
1000001000100000100010000010100010000010000010001
1011111110111111111010111010101111111010111110111
1010000000100000001010101000001000001000100010001
1011111111101111101010101111111011101111101011101
1000000000100010101010000010001010100010001010001
1011111110111010101011111110101010111010111010101
1000000010000000100000000000100010000000100000101
1111111111111111111111111111111111111111111111111
