1111111111111111111111111111111111111111111111111
1000101000000010100000100000000000100000100000001
1110101010111010101010101111111110101010111011111
1000100010001000101010100000000010101010001000001
1011101111101111101010111111111010101011101111101
1000100010001000001010000000001010001010101000001
1110111010111011111011111111101011111010101011101
1010001010000000001010000010001000001010101000101
1011101111111111111010111110111110111010101110111
1010001000000000000010000000100000100010000010001
1010111011111111111110111111101111101111111011101
1010000010000010000010001000101000100000001000001
1011111110111110101011101010101110111111101111101
1000000010000000101000101010000000000000100000101
1011111110111111101110101011111110111110111110111
1000000010100000100010101010000010100010100010001
1011111010111110111011101110111011101011101011101
1010001000100000001010001000101000001000001000101
1010111111101111111010111011101111111111111110101
1010000000000010000010001010000000001000000010001
1011111111111010111011101011111011111011111011101
1010000000000010100010101000001000000000001000101
1010101111101110101110101111101111111111111110101
1010101000101000100000100000100000100010000010001
1010111010111011101111111110111110101010111010111
1000100010000010001000000010000010001000100010101
1110101011111111111010111111111010111111101110101
1010101010000000000010100000000010001000001010001
1010101110111111111110101111111111101011111011101
1010100010100000000010101000100000001000100000101
1010111010101011111010101010101111111110101010101
1010001000101010000010001010000000100000101010101
1011101111111011111111111111111110101111111010101
1000100010001000100000001000000010100000001010101
1110111010101110101011101011111010111111101010101
1000001010100000101010000010001010100000001010101
1011101010111111101011111110111011101111111010101
1010101010001000001000100010001000001000000010101
1010101011101011111110101010101111111010111110101
1010001000100000100010001010100000001010001000101
1011111110111111101011111011101111101011101111101
1000001000100000101000001000100010001010100000001
1111101011101110101111101010101010111010111111111
1000001000001000100000101010101010001000001000101
1011111111111011111110101110111011111111101010101
1000001000001010000010100000100010000000100010101
1011101011101011101010111111101110111011111110101
1000100000100000001000100000000000001000000000001
1111111111111111111111111111111111111111111111111
