1111111111111111111111111111111
1000000000000000100010000000001
1111111111111110101110101111101
1010000000001000100000100000101
1010111110111011101111111110101
1000101000100010100000001000101
1011101011101110111011111011111
1000001000001000100010001000001
1111101111111010101110101111101
1000001000001010101000100000001
1011111011101011101011111111101
1010000010001000001010001000001
1011111010111111111010101111101
1010000010001000001010100000101
1010111111101011101010111110101
1010100000101010101000100000101
1010101110101010101111101111101
1010100010100010101000100000101
1010111011111110101010111110101
1010001000000000000010000000101
1011101111111110111111111111111
1000100000000010100010001000001
1110101111111010101010101011101
1010100010001010101010100010001
1010101110101011101010111110101
1000101000101000001000001000101
1011111011101111101111111011101
1000000010001000100010000010001
1111111110111010111110111110111
1000000000000010000000100000001
1111111111111111111111111111111
