1111111111111111111111111111111111111111111111111
1010001000000000100000100000000010000000100000001
1010101110111110101110111011111010111110101111101
1000101000100010001010100010001010100010001010001
1111101011101111111010101110101010111011111010111
1000100010001000100010100000101010100000100000101
1010111110111010101010111110101010101011101111101
1010000010000010001010000010101000101010001000001
1010111110111111111011111011101111101110111011101
1010000000100000001000001000001000100010100010101
1011111111101111101110101111111010111010111010101
1010001000101000000000101000000010001010000010001
1010101010101111111111111011111011101011111110111
1000101010101000100010001010001000100010100010001
1111101011101010101010101011101110111010101011101
1000101000101010001010101000100010100000101000001
1010101110101011111010101110101010111110101111111
1010101000101010001010101000101010000010101000001
1010101011101010101010101011111011111011101110101
1010101010001010101000100010000000100010001000101
1010101010111011101111111110101111101010111011111
1010000010100010000000100000101000101010100000001
1011111110101110111110111011111010101110101111101
1010001000100000100010001000000010100000100000101
1010101010111111111011101111111110111111111111101
1000101010100000001000101000001000001000000000001
1111111010101111101010101011101011101011111111101
1000000010001010001010101000100010100010001000101
1010111111111010111110101010111110111110101010101
1010100010000000000000101010001000001000100010001
1010101011111111111110101011101011101011111111111
1010101010000000001000101010001000100010001000001
1010101010111111101011101010111110111110111010101
1010101000100000001000101010100010101000100010101
1011101111101111111110101110101010101010101110111
1010001000100000100000100000101010100010001010001
1010111010111110101111111111111010111111101011101
1000100010000010101000001000000010100000100010001
1011111111101010111010101011101110101110111110111
1000000000001010000010101000100010001010000010001
1111111111111011111110101110111011111011111011101
1010000010001010000010100010100000001000001000001
1010101010101010101110111110101111111010101111101
1010101000101010100010000000100010001010100000101
1010101110111010111011111111111010101010111110101
1000100010100010001000000010100010101010100010101
1011111011101111111011111010101110101010101011101
1000001000000000000010000000100000100010001000001
1111111111111111111111111111111111111111111111111
