1111111111111111111111111111111
1000100010000000001010000000001
1110101011111110101010111011101
1000101000000000101000001010001
1011101111111111101111111010111
1010000000100000100010000010101
1011111110101110111010111110101
1000000000101000001000100000101
1111111111101011101111101111101
1000001000001000101000001000001
1011101011111110111011111110101
1000100000100000100010000010101
1110111111101011101110111011101
1010001000001010001000001000001
1010111011111110111111101111111
1000100010000000100000100010001
1011101110111111111010111010101
1000101000100000001010001000101
1110101011101111101011101111101
1000100010001000000010101000101
1011111110101011111110101010101
1010000000101010001000101010101
1010111111101110101011101010101
1010000000100000101000100010001
1010111111111110101110111111101
1010100000000010100010000000101
1011101111111011111011111110101
1000100000101000001000100000101
1110111110101111101110101111101
1000000000100000000000100000001
1111111111111111111111111111111
