1111111111111111111111111111111
1010000010000010000010000000001
1010111011101010101011111110101
1010101010001010101000000000101
1010101010111011101111111111101
1000100010001000001000000010001
1111101111101111101111101110111
1010001000001000001000100010101
1010111110111111111010111010101
1010000010001000000010001000001
1011111011101011111110101111101
1000100010001010100010101000101
1110101110111010101011101010101
1000100010000000101000101010101
1010111011101111101110101010101
1010001000101000001010100010101
1011111110111011111010111110111
1000000010000010001000100010001
1011111011111110101011101011101
1000101000000010101010001000001
1110101111111010101010111111101
1000100000001010100010001000001
1011101011111010111110101110111
1010001010000010001000100010101
1011101110111111101111101010101
1000001000100000100000101010001
1111101011101011111110111011101
1000101010001010000010000010001
1011101010111010101111111110111
1000001000001000100000000000001
1111111111111111111111111111111
