1111111111111111111111111111111111111111111111111
1000000010100000000010000010000000000000100000001
1111111010101110111011101110101111111110111011101
1000000010001000101010001000101000000010001010101
1011111110111011101010111011101011111011101010101
1000100010100010001010001000101010001010101010001
1110101010101110111010101011101011101010101011111
1010101000100010000010101010001010001010101000001
1010111111111010111111101010111010101010101011101
1000100010001010100010001010000010101010001010101
1011101010101010101010111011111110101010111010101
1000001000100010001010000010000000101010100000101
1111111111111111111011101111111110101010101111101
1000001000100000001000101000000000101010101000101
1011101110101111101110101011111111111010111010101
1010000000100000100000101000001000000010100010101
1011111110111110111111101111101011111110101110101
1000001010100010101000101000001000100010001000101
1011101010101010101010101011101110111011111011101
1000101000001010100010000010000010100010001000101
1110101111111110101111111111111010101010101110101
1000100010000000101000001000001010101010100010001
1011111010111111101011101011101110101110101111101
1010001010100000100010001010101000100000100000001
1010101010101110111011111010101011101111111111111
1010101010101010000010000010001010001000100000001
1110101010101011111110111110111010111110101111101
1000101010100010000000100010000010100000101010001
1011101010111010111111101011111110101010101010111
1000100010100010100000101000000010101010100010001
1010111110111110101110101110111110111011101111101
1010100000100000100010101010001000100010001000001
1010101111101111111010101011101011101110111011101
1010100010001000000010100010001010100000101010101
1010111010111010111110111010111010101111101010101
1010100010001010001000100010000010001000001010001
1010101111101011101111101111111110111011111011111
1010100000001000100010001000000010000010001000001
1010111111111011111010111110111111101110101111101
1010000010000010001010000010100000101000101000101
1110111010111110101011111010101011101011101010101
1000101010101000100000100010001000001000100010101
1011101010101011111011101111111011111110111110101
1000100010001010000010001000001010000010001000101
1110111111101011111110111110101010111110101011101
1000100010001010000010000010101000100010101000001
1011101010111010111011111010101111101011101111101
1000001000001000001000000000100000001000001000001
1111111111111111111111111111111111111111111111111
