1111111111111111111111111111111
1000100010001000000000100000001
1110101010101011101110101111101
1010101010100000101000101000101
1010101110111110101011101010101
1000100000100010101000001010101
1011111111101010101111111011101
1000100000101010101000000000001
1110101110101011101011111111111
1000101010101000001000100010001
1011101010101111111110101011101
1010001010101000100010001000101
1010111010101010101011111110101
1010100000101010101000001000101
1010111110101011101011111011101
1010000010001000001010001000001
1011111011111111101010101111101
1010001000100000101000101000001
1010101110101110111111101011111
1010101000100010000000001000101
1010101011111011111111101110101
1000101000001010000000100010101
1111101111101011111110111010101
1010001000001010000010000010001
1010111011111010111010111111101
1010100000100010101010000000101
1010101110101010101011111110101
1010101000101010001010001000101
1010111011101011101010101111101
1000000010001000001000100000001
1111111111111111111111111111111
