1111111111111111111111111111111
1000001000000000100010000010001
1111101111111010101010101011101
1000100000100010001010101000001
1011111110101111111110101111101
1000001010101000000000100000101
1010101010101011111111111110101
1010100010100010000010100010101
1010111110101110111010101010101
1010100000100010101010101000101
1110101111111010101010101111111
1000100010001010100000100000001
1011111010111010111110111111101
1000001010000010000010001000101
1011101010111111111010111010101
1000101010100000001010100010101
1011101010111011101011101110101
1010001010001000101010001010001
1010111011101110101010111011101
1010100010101000100010100000101
1010101110101011111110111010101
1010101000100010000010100010101
1010101010111010111010101111101
1010001010100010001000100000101
1011111010101111101111101110101
1000100010001000001000001010001
1110111111111011111011111011111
1010100000100010000010001000101
1010101110101110111110101010101
1000001000001000000000100010001
1111111111111111111111111111111
