1111111111111111111111111111111111111111111111111
1010000000001000000000000010001000100000000010001
1011101111101111111011111010101010101111101011101
1000001000100000001000001010100010000000101000101
1111111011111111101111101010111111111110101110101
1000101000000000101000101010100000100010101010001
1010101011111110101010101010101110101011101011101
1010001010000010001010001010101010001000001010001
1011111010101011111011111011101011111111111010111
1000100010101000000010100010001000100000000010101
1010101110101011111110101110111110101110111110101
1010001000101010001000100010100000100010000010101
1011111111101110101011111010101111101111111010101
1000000000100000101010000010100000001000000010001
1111111110111111101010111110101111111011111111101
1000100000100000101010100000101000001000100000001
1110101111101110101010101111111011101110101111111
1000100010001000101010100000100010100010100010001
1011111010111110101010111110101110111010111010101
1000001010100010001000000010100000100010100010101
1110111010101011111111111010111110101110101110101
1000100010001010000000100000100000101000101000101
1011101111101010111110101111101111101010101011101
1000100000101010001000100010000010001010101010001
1010111110111010111011111110111110111110101010111
1010000010001000100010000000001000100010100010001
1111101111101011101010111111111011101010111111101
1000001000001010001010100000100010001000100010001
1011111011111110111110101111101111101111101010111
1010000010000000100010100000100000100010001000001
1010111111101011101010101110111110111010111111111
1010100000001010001010100010000010001000000010001
1010111110111010111010111011101011101111111110101
1010001000100010101000100000101000100000000010101
1011101011111110101111101111101111111111101010101
1000001010000000100000001000100000100000101000101
1011111010111111111011111010111110101110111111101
1000100000100000001010001010100010101010100000001
1110101111101111101010111010101010101010101111101
1000100000001000101000100010001000101010001000101
1011111111111011101111101111111110101011111011101
1000100000000010000000100010000010101000001010001
1110111011111010111110111010101110101011101010111
1010001000001000100010100010100000101010101010001
1011101011111110101010101111101111101010101011101
1000001010000010101010001000101000101010000000101
1011111110111011101011111010111010101011111111101
1000000000100000001000000010000010001000000000001
1111111111111111111111111111111111111111111111111
