1111111111111111111111111111111
1010000000100000000000000000001
1011111110101111111111111011101
1000000010001000000000001000101
1111111010111010111111101110111
1010000010001010100000100010001
1010111111101011101110111011101
1000100000100010001010001010001
1011101110111010111011101110101
1000100010001010001000100000101
1110101011111011101110111111101
1000101000001010100010000000001
1011111011101010111011111110111
1000001000100010001000000010101
1111101110111111101111111010101
1000101000100000000000100010101
1110101110101111101111101110101
1000100010100010001000001000101
1010111010111010111011111011101
1010001010000010101000100000001
1011101011111110101110101111111
1000101010100000000010100010001
1010101010101111111110111110101
1010101010001000000010001000101
1010111011101011111011101011101
1010001000101000101000100010001
1011101110101110101110111010101
1000101000100010100010001010101
1110101011111110101011101110101
1000100000000000101000000000101
1111111111111111111111111111111
