1111111111111111111111111111111111111111111111111
1010100000100000000000001000000000001000001000001
1010101011101011111111111011111011101011101011101
1010001000001010000010001000001000100010101000101
1010111111111010111010101011111010111110101110101
1010000000001000001000100010001010100000101000101
1011111011111111101111111110101110101110101011101
1010001010000000101000100010100000100010101010001
1010101110111110101010101010111111101011101110101
1010100010100010100010101010000010001000100010101
1010111010101010111110111011111011111010111010101
1000101000101010100010000010000010001010001000101
1111101111111010101011111110101110101111101111101
1000001000001010001000001000101000100010000000101
1011101010101011111111101011111011111010111111101
1000100010101000000010001000000010001010100010001
1110111110101011111110111111101110101010101010111
1000100000100010001000100000100000101010001000001
1011101111111010101011101110111110111011111011111
1000101000000010101010000010101000100010001010001
1110101110111110101011111010101011101110101010101
1010100010100000101000000010100000100000101010101
1010111011101111101111111110101111111111101110101
1010101000000010001000000010101000000000100000101
1010101111111110101111111010111011111110111111101
1010100000100000100000001010000010001010000000101
1010111010101111111111101011111110101011111110101
1010000010101000001000101000000010101010001000101
1011111110101011101110101011111010101010101011101
1000001000101000101000101010100000100010100010001
1010101011101010101010101010101111111110111110101
1010101010101010100010100010101000000000101000101
1010111010101010111111111110101011111111101010101
1010100000101010001000000010001010000000001010101
1110101111101011101011111010111010111011111010111
1000100010001000100010001010100010101000001010001
1010111010111110111111101010101110101111101011101
1010001010100010100000101000101000100000100000101
1011101010111010101110101111101011111110111111101
1010101010001010100010100000101000001000001000001
1010101011101010111010101111101111101011101011111
1010001010101000000010001000001000100010001010001
1011111010101111111111101011111011101111101010101
1000001000100000100000001010001000001000101000101
1011101110111110111111111010101111111010111011101
1000100010100010100010001000100000100010001010001
1110111010101010101010101111111110101111101110101
1000001000001010001000100000000000001000000000101
1111111111111111111111111111111111111111111111111
