1111111111111111111111111111111
1010000010000010000000100000001
1011101010101110101110111011101
1000101010100010101010000010001
1110101011101010101011111110111
1010001000101000101000100010101
1011111110101111101010101010101
1000100010100010001010101010001
1010111010111010111011101011101
1010000010100010100010001000101
1011111010111110101110111110101
1000001010100010100010000010001
1011101010101010111011111011111
1010101010101000100010001010001
1010101110101111101010101010101
1000100000101000101010101010101
1110111111101010101011101011101
1010000010001010001000001000001
1011111011101011111011111111101
1000001000001010000010000000101
1011101111111010111110111011101
1010001000000010001010001000001
1010111011101111101011101111111
1010100010001000100000101000001
1010101111111010111011101011101
1010001000000010100010001000101
1011111011111110111110111011101
1010001010000010000000100010001
1010101011111011111111111110101
1000100000000000000000000000101
1111111111111111111111111111111
