1111111111111111111111111111111111111111111111111
1010001000100000001000000000000000001000000000101
1010101010101110101011111110111111101010111110101
1010101010001000101000100000100010001010001000001
1010101111111011101111101111101110111011101111101
1000100000100010100000101010001000101000100010101
1111111110101110111110101010101011101110111010101
1000000010001000000010001000100010000010100010001
1011111111111011101111111011111111101010101110111
1000100000001010001000001000100000101010101010101
1110101111101010111011101110101110111010101010101
1000101000001010000010001000100010000010101000101
1011101011111011111110101011101010111110101011101
1000001000001010001000101000101010100000101010001
1111111110101011101011111110111011101111101011101
1000100010101000101000000010001010001000101000001
1010101011101110101111101011101010111010101111101
1010001000001010100010001010001010100010101010001
1011111111101010101010111010111010111011101010111
1010000000001010001010001010100000100010001000101
1011111110111011111011101110111011101010111011101
1000000010000010001010100010001000001010001010001
1111101011111110101010111011101111111111101010101
1000101000000000100000001000100000000000101000101
1010111011111111111111111010111111111110101111101
1010001000000000100010000010100000000010100010001
1011101111111110101010111111101111101010111010111
1010100000001010101000100000001000001010001010101
1010111111101010101110101111111011111111101010101
1010000000101010100010100010001000000000001010001
1011101110101010111010111011101111111111111011101
1000101010001010100010101000100000001000001000101
1110101011111010101110101110101011101011101010101
1000101000000000101000101000101000101000100010101
1011101011111111101011101011101110101111101110101
1000101000100000001000001000100010100000101000101
1010101111101111111111111110111110111110101011101
1010100000001000000010000010100010000010101010101
1110111111101011111010111010101011111010111010101
1000100000101000001000001010001000000010001010101
1011101110111111101111111011111111111111101010101
1010001010000000000010001010000000001000101010001
1010111011111111111110101010111110111010101010111
1000100000000000100010100010100010000010101010001
1011111111111110101010101110111011111110101011101
1000000000000000101000101000100010000010101010001
1111111111111110101111111011101011101010101010111
1000000000000000100000000000001000001010000010001
1111111111111111111111111111111111111111111111111
