1111111111111111111111111111111
1010001000000000000000000000001
1010101010111111111111111111101
1010100010000000000000000000101
1010111111111111101111111110111
1010001000100000100000100010001
1011101110101110111011101011101
1010000000100010001010001000001
1011111110111011101110111111101
1000001000001010101000100000101
1111101111111010101011111011101
1000101000100010001000100010001
1110101010101110111010101010111
1000100010100010100010101010101
1011111110111010101110101010101
1010000010000010101000101010101
1010111011111110111011101010101
1010101000000010000010001010101
1010101111111011111110101110101
1010000010001010000000100000101
1011111010111010111111111111101
1000000010100010100000000010001
1011111110101110101111111010101
1000100000100000100010000010101
1110101110111111101011101110101
1010100010001000001000101000101
1010111011101111111010101011101
1010001010001000001010101010101
1011101010111011101110101010101
1000000010000010000000100010001
1111111111111111111111111111111
