1111111111111111111111111111111
1010100000100000001000001000001
1010101010101110101110111011101
1010101010100010100010001010001
1010101010111110111010101010111
1010001010100000101010100010001
1011111010101111101010111111101
1000001010001010000010000010101
1111101011111010111111111010101
1000101010000010000010001010101
1011101011101011111010101010101
1000101000101010001010100000101
1110101110111010101010111111101
1000100000100010100010100010001
1011111111101110111110101010101
1000000000000010100010101000101
1011111111111010101110101111101
1000100000001000100000101000101
1110111111101111111111101010101
1010001000100000100000001010001
1011101010101110101111111011111
1000101010001010001000100010001
1010101011111011111010101111101
1010001010000000001010001000101
1011111010111011111011111010101
1000000010101000001000000010001
1111111110101111101111111111101
1010000000100010100010001000101
1010111111101010111010101010101
1000000000001000001000100010001
1111111111111111111111111111111
