1111111111111111111111111111111
1010001000100000000000001000001
1010101010101110111111101011101
1010100010100010100000100010001
1010111110101011101110111110111
1010100000101000001010100010101
1010101111111011111010101110101
1000100000001010000010100010101
1111111111101010111010101010101
1000000010001010001010101000101
1011111010111011101110101111101
1000100010100010001000101000001
1110101110101110101011101111101
1000100010100000101010100000001
1011111010111110111010111111101
1010001010100010100010000010001
1011101010101011101110111010111
1000101010101000001010101010001
1110101010101111111010101011101
1000100010001000000010101000101
1011101111111011111110101110101
1010100000001000000010100010001
1010101111111011111010111011111
1010001000000010100010001000101
1011111011111110101111101010101
1010000010000010100000001010001
1010111111101010111111111011101
1010000000101000100010000010101
1011111110101110101011101110101
1000000000001000001000001000001
1111111111111111111111111111111
