1111111111111111111111111111111
1000100000000000100000001000001
1110101111111010101111101010101
1010100000001010001000101010101
1010111111111011111010101110101
1010000000001010100010100000101
1011111111101010101011111111101
1000100000101010101000000000101
1010111110101010101111111110101
1010000000100010101000000010101
1010111111111110101011111010101
1010100000000000101010001000101
1011101111111011101010101111101
1000001000100010001010100010001
1011111110101110111010111010111
1010000000101000101000101010001
1010111011101011101111101011101
1000101010001000000010001000101
1111101010111111111010111110101
1000001010001000100010000010001
1010111011101010101110101011111
1010100010100010001000101000001
1011101110111111111011101111101
1000001010000010001010101000001
1011111010101010101010101111111
1010000000101010101000100000001
1011111111101010101111111110101
1010000000101000100010000010101
1010111110101111111010111011101
1000100000001000000000100000001
1111111111111111111111111111111
