1111111111111111111111111111111
1010000000001000100000000010001
1010111011101110101111101011101
1010001010000010001000101000101
1011101011111011111010101110101
1010001000001000000010100010101
1011111110101111111110111010101
1000000010100010000000100010101
1111111011101010111111101110101
1000001000101010100010000010101
1010111110101010101010111010101
1010000010101010101000100010001
1011111010111010111111101111101
1010001010001010000000100010101
1010101011101011111110111010101
1010101000001000100000000010001
1011101111111010111111111110111
1000100000001010000000001010101
1110111011101011111111101010101
1010001010001000000000101000101
1011101010111110111111101011101
1000101010000010100000101000001
1110101111111010101110101111101
1000100010001000101010001000101
1010111010101111101011111011101
1010001010101000101000000010001
1011101010101010101010111110111
1010001000100010101010000010101
1011111111111110101011111010101
1000000000000000001000001000001
1111111111111111111111111111111
