1111111111111111111111111111111111111111111111111
1010000010100000001000000000000010001000001000001
1010111010101110101111111011111010101011101011101
1000101010101000100000100010001010100010001010001
1111101010101011111110101110101010111110111010111
1010000010001010000010001000101010100010100010001
1010111111111010111111111011111010101010101111101
1000100000000010100000100000000010101010100000101
1011101110111110101011101111111110111010111011101
1000101010000010001000101000000000001010001010001
1110101011111011111110101111111111101011101010101
1010100010001010000010000000000000101000001010101
1010111011101010111011111111111110101011111110101
1010100000101010101000101000100000101010000000101
1010111110101010101110101010101111101011111011111
1010000010101010000010100010000000001000001010001
1011111010101011101110101111111111111111101010101
1000000010101000001000101000000010000000101000101
1011111110101111111011111011111010111011101111101
1000100010100000100010001010001010100010001000001
1110101010101110101110101010101010101110111011111
1010101010101000101000101000101010100010001000001
1010101010101110101011101111101011111011101111101
1010101010100010100010100000101000001000000000001
1010101110101010111110111110101111101111111111101
1010100000101010100000000010001000001000001000101
1010101111111010111011111111111011111011101010101
1000100000000010000010000000001000000010001010001
1011111111111111111110111111101011111110111011111
1000001000100000000010100010001000101000101010001
1111101010101111111010101010111110101011101010111
1000101010001000001000101000100000001010001010001
1010101011111111101111101111111111101011101011101
1010001000000000100000100010000010001000101000101
1011111110111110101110111011101011101110101110101
1010000010100010101000001000001000100010100000101
1010101010101010111011101111111110101110101111101
1010101010001010001000100010001000101000101000001
1011101011111011101110111011101011111011101011101
1000001000100010100010001000001000100010000010101
1111111110101110111010101111101110101111111110101
1010000010100000100010101000001000100000100010001
1010101110111110101110101110111011101110101010111
1010100010000010100010100010100010000010001010001
1010111011111010111010111010101111101111111011101
1010001000001010100010001010100000101000100010001
1011101111101011101111101011111110111010101110111
1000000000100000001000001000000000000010001000001
1111111111111111111111111111111111111111111111111
