1111111111111111111111111111111111111111111111111
1010001010001000001000100010000000000010000000101
1010101010101010101010101110111010111110101110101
1000101000100010100010100000100010100000101000101
1111101110111110111110111111101111101111101011101
1000100010001000100010001000001000000010001010001
1010111011111011101111101011111011111110111010101
1010001000000010000010001000001000100010101000101
1010111111111110111010111110101011101010101111101
1010100000000000001010000010100010001010100000101
1011101111111011111011111011111110111010101011101
1000101000001000100010001000000010100010101000001
1010101011101111101110101111111010101110111111101
1010001010000000101000100000001000101000000000101
1011111011111110101011101111101111101111101110101
1000001000100010001000100010001000100000101000101
1111111110101111101110111011111010111110101011101
1000000000101000101010101000000010001000101000101
1011111111101010101010101111111110101011101110101
1000100000000010001010100000100000101010001000101
1110111111101111111010111010101111111011111011101
1000100000100000001010001010101000000010001010001
1011101110111111101011101110101011111110101010111
1000000010100010001000100010100010000000100010001
1011111110101010111010111010111110101111111111101
1000100000101010001010101000001000100000001000101
1110101111101011101010101111101110111111101010101
1010100000101000100010001000100010000010101010101
1010111110101110111110111010111011111010101010101
1000100010100010000010100010000010001000101010101
1011101010111011101110101111111110101110101110101
1010001010001000100000100000100000100010101000101
1011111011101111101111111110111111111010101011101
1010000010100000100010000010100000001000101000001
1010111010111110111011101110101111101111101011111
1010001000000010101000001000101000100000001000101
1010101111111110101011111011101010111111111110101
1010101000000000101010001000101010000010000000101
1011101010111111101010101110101110101110111111101
1000001010100010100010100010100010101000100010001
1111101010101010101110101110111010101011101010101
1000101010101010000010100000100010101000001010101
1011101011101011111110111111101110101111111010111
1000001000001010000000100000001010100000101010001
1011111111111010111111101111111010101110101011101
1000100000100010100000001000000010100010001000001
1110101110101110111110111011111010111011111111101
1000001000100000000000100000001000001000000000001
1111111111111111111111111111111111111111111111111
