1111111111111111111111111111111111111111111111111
1010000000000000001000100010000000100000000010001
1011111110111111101010101010111010101111101011101
1010001000100000001010001010001010100010001000101
1010101011101111111011111011101010111010111110101
1010100010000000001000101000101010100010000010001
1010101111111111101110101011101010111111101011111
1010101000000000101010001010001010000000101000001
1010111011111010101011101010111011111110111111101
1010000010001010100000101000100010000000100000101
1011111010101110111110101111101111111110101110101
1000001010100010000010100010001000000010001010101
1111101110111010111011101110101011111011111010101
1000001000100010001000101000101010100010000010001
1011111011101111101110101011111010101110111011101
1000000010101000001010001010001000101000001000101
1111111110101011111011111010101110101111111011101
1000000000101010000010001000100000100000001000101
1110111110101010101010101111101111111111101010101
1000100010101010101010101000100010000010001010001
1011101011101011101110101010111010101110111011111
1010001000101000101000100010100010101000101010001
1010111110101110101011111110101110101011101010101
1010100010101000101010000010100000101010001000101
1010101110101011101010111010111111101011101111101
1010100010101010001010100010101000101000100000101
1010111010101010111011101110101010101110101111101
1010000010101000100010001000100010000010101000001
1011111010101111101110111011111111111110101011111
1010000010001000101000001000100000000000101010001
1010111111111010101011101110101111111111101011101
1010001000000010001000100010100000000000101010001
1011101110111111111011111010111111111010101010101
1000100010000010100010000010001000001010100010101
1010111010111010101110111111101011101110101110101
1010100010001010101010100000001000100010100000101
1110101111111010101010101111111110111010111111101
1000100000001010000010100010000000100000100000001
1010111111101011111110111010111111111111101111111
1010000010101010000010001010100010000010000010001
1011111010101010111010111010101010111011111110101
1010001010101000100010000010001000101010000000101
1010111010101111101110111111111110101010111111101
1010000000100010001010100000000010101000000010001
1011111111111010111010111011111010101111111110101
1000000000001010001010000010001010001000000010101
1011111111101011101011111110111011111011111010101
1000000000100000001000000000000000000010000000101
1111111111111111111111111111111111111111111111111
