1111111111111111111111111111111111111111111111111
1000100010000000001000000000000000001000000010001
1110101110101110111011111110111111101111101010101
1010100000100010100010100000100010000000001010101
1010111011111011101110101111101011111111111011101
1010001000001000001000100000001000100000100000001
1011101111111011111010111111111110101110111111101
1000100000001000101010000000001000101010001010001
1011111111101110101011101111111010101011101010111
1000000000100010100010001000000010101010001010101
1011111110111010111110101011111011101010111010101
1000000010000010000000101010000010001010100000001
1111111011111111111111101010111110111010111111101
1000100010000000001000001010000010000010000010001
1011101111111110111011111011111111101111111011111
1000101000100010000000001000000010001000000010001
1110101010101011101111111110111010111010111110101
1000100010001000100010000010101010001010100000101
1011111111111110111110111010101010111010101111101
1000000010000010100000101010101000100010101000101
1011101110111010101111101010101111101110101010101
1010100000101000101000100010001000100010101010101
1010111111101111101010101111101011111011101011101
1010000010000000000010101000000010001000101000101
1011101011111011111110101011111110101110101110101
1010001000001000001000101010001000100010001000101
1010111111101111101011101010101011111010111011101
1010100000100010001010001010100010000010001000101
1010111110111011111010111010111110111111101010101
1010100000001000000010001010001010000010001010101
1010101110111111111111101111101011111010111110101
1000100010100000000000100000001000000010000000101
1111111010101111111010111111111011111111101111101
1000000010101000001010001010001010000000101000101
1010111111101010101011101010101011111010111010101
1010000000001010101000100010100010001010000010101
1011111111111110101110101110111110101011111110101
1000000010000000101000101000100000100010000010001
1111111010111110111011101011111011111110111011101
1000001010100010100010001010000010000010001010001
1011111010101010101111101011101110111110111010111
1010001000101010101000101000001000000000100010101
1010101111111010101010111111111011111111101010101
1010100000000010101010100000001000100000101010001
1010111110111010101010101111101110101011101111101
1010100010001010100010100000101000101000101000101
1010101011101110111110111110101011111110101010101
1000001000100000000010000000100000000000100010001
1111111111111111111111111111111111111111111111111
