1111111111111111111111111111111
1000000010000010000000000010001
1111111010111110101111111011101
1000100010000000101000001000001
1011101110111111101111101111101
1000001010001000101000100010001
1011111011101110101010111010111
1000100000000000100010100010001
1110111110111111111110101111101
1010000010100000000000100000101
1011111011101111111111111010101
1000001000001000001000000010101
1011101111111010111010111011101
1000100000001010100010001010001
1110111110111010101111101010111
1000000010000010001000001010001
1111111111111011111011111011101
1000000000001000001010001010101
1011111111101111101010111010101
1000101000000000101010000010101
1110101011111110101010111110101
1000100010000010101010100000101
1011111110111010111010101110101
1000000010100010001010001000101
1011111010101111101011111011101
1010001000100010000010000010001
1011101111111011111111111010111
1000100010100010000000001010001
1110101010101110111111101111101
1000001000100000000000100000001
1111111111111111111111111111111
