1111111111111111111111111111111
1010000000001000000000000000101
1010111111101011111111111110101
1000100000100010001000000010001
1111111011111110111011111011101
1010000010000000000010000010001
1010101110111111111110111110111
1000100000000000000010001000101
1011111111111111111111101011101
1010001010000000100000001010001
1010101010111110101111101011101
1000101010100010101000101000001
1111101010101010101010111111101
1000001010101000001010000000101
1011111010101111111011111010101
1010000010100010000010001010101
1011111010111110111110101010101
1000001010001000100000101010101
1111101011101011111011101011101
1000101000101000100010001000001
1011101110101110101110111111111
1000101000101000100010100000001
1010101011101011101010111110101
1010001000100010001010000000101
1011111010111111111011111111101
1000100010000000001000100000101
1110111111101111101010111011101
1000100000101010001010001010001
1011101110101010111111101010111
1000001000001000000000001000001
1111111111111111111111111111111
