1111111111111111111111111111111111111111111111111
1000001000001000100000000000101000100000000000101
1111101010111010101111111010101010101111101110101
1010001010000010001000000010100010001000101010101
1010111011111111101011111110101111111010101010101
1000100010100000101000100010100000000010101010001
1011101110101110101110101110111011111011101011101
1010100010101000100010101000100010001010001000101
1010111010101110111110101011111110101010111010101
1010000000100010000010101010000000101010100010001
1011111111111011111010101010111111101110101111111
1010000000000010001000101000100000100000101000001
1010111111111110111111101111101111111111101110101
1000100010000000100000000000001000100000100000101
1111101010111011101110111111111010101110111111101
1010001000001010001010000000000010001010000000101
1010111111111010111011111111111111111010111111101
1010100000100010000010000000100000000010000010001
1010111011101111111011101010111011111011111010111
1010000010001000001000101010001010000000001010101
1011101110101011101110101011101011111111111010101
1000101000101010001000101000101000000010001010101
1010101011111010111011111110101111111010101010101
1010101010000010001000100000100000000010100010101
1011101010111111101110101011111111111010111010101
1010001000000000100010101010000000100010001010101
1010111111111111101110101010111110101111101110101
1010100000000010001000101010001010100010100000101
1010101111111010111011101111101010111010111111101
1000101000001000100010000000101010001000100000001
1011101111101011101110111110101011101110101110101
1010100000101010001010100010000000101010101000101
1010111110101010111010101011111111101010101011101
1000001010100010001000001000001000001000101000101
1111101010111011101111111111101011111011111010111
1000100010001000100000000000101010001000001010001
1010111011101110111111111110111010101111101011101
1010100010101000100000000010100010100010001000101
1110101110101110111111111010101110111110111111101
1000100010100010000000001010001000100000100000101
1011111010111011111111101011111010101111101110101
1000001000001000001000000000100010100010001010001
1010111011111111101111111110111010111011101011101
1010100010001000001000001000000010001010001000101
1010101110101011111011101111101111111010111010101
1010001000100010000010100000101000000010100010101
1011111011111110111110111110111011111110101111101
1000001000000000000000000010000000000000100000001
1111111111111111111111111111111111111111111111111
