1111111111111111111111111111111111111111111111111
1010001000000000000010000000001000000000000010001
1010101111111110111010111110101011101111111011101
1000101000000010001000001000101000100000101010001
1111101011111010111111101011101011111110101010111
1000100010100010100010001010101010001000101010001
1010111110101110101011111010101110101011101011101
1010001010001000101000100010101000100010001010001
1110101010111111101110101110101011111110101010101
1000100010100010001010001000001010001000100010101
1011111110101010111011111011111010111011111110111
1010000010001010100000001000000010100010100000001
1010111011111010101111101111111110101110101111101
1000100000100010100010100000000000101000001000001
1011101110101110111010111111101011101111111011101
1000100010101010001000101000101000101000000010101
1111111010101010101110101010111110101011111110101
1000100010101000101010101010000000100010000010001
1010101110101111101010101011111110111111101010111
1010100010100000101010001010000000100000101010001
1010101010111110101011101010111110111010111011101
1010101010100010001000101010100010000010000010101
1010111010111011111010101011101011111111111010101
1010000010000010001010001000001000001000000000101
1011111111111110101011111111111110101111111111101
1010000000100010100010000000100010100000001000001
1010111110101010111111111011101011111111101011111
1000100010001010000000100010001010000000001010001
1011101011111011111110101010111010111011111010101
1010001010001000001000101010001000100010000010101
1010111011101011101011101011101111111110111111101
1010001000101000101000001000100000100000100010001
1011101110101110101111111110111110101111101010101
1000001000001000101000000010100010001000101000101
1111111011111011101110111110101011111010101111101
1000100000100010000000100000101010000010100010001
1010111011101110111111101111101010111110111011111
1010001010001000100000101010001000100010001000001
1011101110101111101110101010101111101111101011101
1010100000101000100010101000101000100000001000101
1010111111101010101110101111101110101111111111101
1010000010001010101000101000001000100000100010001
1011111010111010101010101011111010111110101010101
1000001000100010101010101010000010100010101000101
1011101111101110101011101010111110101110101111101
1010001000001010001000101010100000001000101010001
1010111011111011111110101010111111111011101010111
1010000000000000000010000010000000000000001000001
1111111111111111111111111111111111111111111111111
