1111111111111111111111111111111
1010000010000000000000100010001
1010111011101111101110101011101
1010101000101000101000101000001
1010101110101010101011101011111
1000100010101010001000101010001
1111101110101011111110101110101
1000100000101000000010100000101
1010101111111111111010111110101
1010100000000000001010100010101
1010111111111111101010101011101
1010001000001000101010001000001
1011101011101010101011111111101
1010101000101010001010000000001
1010101110101011111010111111111
1000100000101000000010101000001
1011111111101111111110101010101
1010001000001000000010100010101
1010101011101011111010101110111
1010101010000010001010100010001
1110101011111110111010111110101
1000100010001000000010000010101
1011111010101111111011111011101
1010000010101000001000001010001
1011111110101011101111111010111
1010001000100010100000000010001
1010101011111110111111111110101
1000100010000000000000100000101
1011111110111111111110111111101
1000000000100000000000000000001
1111111111111111111111111111111
