1111111111111111111111111111111
1010100000001000000000000000001
1010101110101111111011111111101
1010001000100000001000100000101
1011111011111111101110101110101
1010000010000000100010001000101
1010111110111011111011111011111
1010000010001010000010001010001
1011101010101010111110101010101
1000101010101010001000100010101
1110111010101111101110111110101
1010000010100000101000100000101
1011111110111110101011101111101
1000001010100010001000000010001
1110101010111011111111111110101
1000100010000010000000000010101
1011111011111010111111111010101
1000001000001010100000100010101
1011101111101010101110101110101
1000101000101000101000101000101
1110101110101111101011101110101
1010100010000000001000101000101
1010111011111111111111101011101
1010001000100000001000100010001
1011101110101111101010111110111
1000101010100000101010001000101
1011101010111110101010111011101
1000100010000010101010001000001
1010111011111010101011101111101
1010000000001000100000100000001
1111111111111111111111111111111
