1111111111111111111111111111111
1000100010000000100000000010001
1110101110111011101011111011101
1010100000001000001000001000101
1010111111111111111111101110101
1010001000001000001000101010101
1011101011101011101010101010101
1000001000100010100010001010001
1011111110111110111111111011101
1000000000100000000000001000101
1111111111101111101111111010101
1000001010001000001000100010001
1110101010111011111010101111111
1000100010101010001010001000001
1010111110101010101011111011101
1010100000101000100010000010101
1010101111101111111110111110101
1010101000000000100000001000101
1011101110101110111111101011101
1000100010101000100010000010001
1010111011101011101011111110101
1010001000001010001010000000101
1011101111111011101010111111101
1000101000001010001010001000101
1011101011101010111011101110101
1010001000100010001000001000101
1010111110111111101111111011101
1010000010001000001010000010001
1011101111101011111010111010111
1000100000000010000000001000001
1111111111111111111111111111111
