1111111111111111111111111111111
1000100010000010000000000000001
1110101011111010111111101111101
1010101000001000100000001000001
1010101111101011101111111011111
1000101000101000100010001000001
1011101011101110111011101111101
1000001000100010100010000010101
1111111110111010101110111010101
1000000000001010100010100000101
1010111110111010111010101111101
1010001000100010100010100010001
1011101011101110101110111110111
1000101000101000101000100000101
1011101011101011101110101111101
1010001010001000100010000010001
1110101110111111111011111011101
1000101000100000100010001000001
1011111011101110101110101111101
1010000010001000100000100010001
1010111110111011111110111010111
1010000010001000100010001010101
1011111010101110101011101010101
1000100010101010001010001010101
1010101111101011111011101010101
1010100010001000001000101010001
1010111010111010101110111011101
1010001010100010100010100010001
1011111010101110111110101110111
1000000000100010000000001000001
1111111111111111111111111111111
