1111111111111111111111111111111111111111111111111
1010000000001000000010000000100000100010000010001
1010111111101011101011101111101010101011101010101
1000101000001010001000001000001010001000001010101
1111101011111110111111111011111011111111111011101
1000001010000010001000001010000010001000000000001
1010111010111011101011101010111111101011111111101
1010001000101000100000100010000000100010000010001
1011101111101110101111111111111110111110111011111
1010000010000010100010000010000010000000101000001
1010111010111010111110111010111010111110101111101
1010001010001000100000101000101010100010001000101
1011101011101111101111101111101011101011111010101
1000101000100010001000000000001000001010000010001
1111101011111010111111101111101111111010111111101
1000001010000010001000100010001000001010100000101
1011111010111110101010111010111110101010101011101
1010000010001000101010100010000000101000101010001
1010111111101011101010101110111111101111111010111
1010100010001000101010001010100000101000000010101
1011101010111111101011111010101110101011101010101
1010001000100000101010000000100010101010101010101
1010111111111010101011101111111010101010101110101
1010101000000010001000101000000010101000100010001
1010101011101111111010111011111110101110111011101
1010100010001000001010000010001000101000100010001
1010111110111111101011111111101010111011101010111
1010000010000010001000100010001010100010101010001
1011111010111010111110101010111010101110101111101
1000001010001010000000101010100010100010100000101
1110101011101010111111101010101111111010111010101
1000101010001010100000001000100010000010100010101
1011111010111010111110111111111010111110101110101
1000000010001010000000100010001000000000101000101
1011111111111011111111101010101011111111101111101
1000100000001010000000101000101010000000101000001
1110111011101010111110101111101010111110101011111
1010001010001000100000101000101010100000101010001
1011101010111111101111101110101110101111101010111
1000100010100000101000000000100000101010001010001
1011111110111010101011111111111111101010101010101
1000000010000010101010001000000000101010100010101
1011111011111110101010101011111110101010111111101
1010001000000000100010101000001000001010100000101
1010111111111111101110101111101111111010101110101
1010000000100000000010100000100000100010001010101
1011101110111111111110111110111110101011111010101
1000001000000000000000100000000000101000000000001
1111111111111111111111111111111111111111111111111
