1111111111111111111111111111111
1010000000001000000010000000001
1011101111101010111010101111101
1010001000101010001000101000101
1010111110101111101111101010101
1010000010100000100000101010101
1011111010111110111110111010111
1000000010000010000010001010001
1111111110101111111011101011101
1000001000100000100010001000101
1011111011111010101110111110101
1000001000001010101000000010101
1011101110111011101011101110101
1010001000100010001000100000101
1010111011101110111111111110101
1010000010100000100000000010101
1011111110111111111011111010101
1010000000001000000010100010101
1011101011111010111110101111101
1000101010000010000010100000001
1110101010111111111010111111101
1010101000100000000010001000101
1010111111101111111111101010101
1000100000001000100000001010101
1011101111111010101110111010101
1000001000000010101010001010001
1111111011111111101011101011111
1000000010000010001000101000101
1011111110111010111010101110101
1000000000001000000010100000001
1111111111111111111111111111111
