1111111111111111111111111111111
1000100010000010000010000000001
1110101110101110101011101111101
1010100000100010101000001000101
1010111110111010101111111110101
1010000010001000100010001000101
1011111011101111101010101011101
1000001010001000101000101000001
1011101011111010111111101011111
1010001000100010000000001000101
1010111110101111111111111110101
1010000010101000000010000000101
1011101010101011111010111111101
1000101010101000001010000010001
1111101010101111101011111010101
1000001010001000001000101010101
1011111011111011111010101011101
1010001010001010100010001000101
1010101010111010101111111110101
1010101010001010100000000010001
1010111011101010111111111011101
1010000000001000101000000010101
1011111111101110101011111010101
1000100010000010101000100000101
1110101010111110101110111111101
1000101010100010100010100000001
1011101011101010101110101111111
1010001010001010101000100000001
1010111010111010101011111111101
1000001000001000001000000000001
1111111111111111111111111111111
