1111111111111111111111111111111
1010000010000000000010000010001
1010111010111011111010101110101
1000101010001010001010101000101
1111101011111010101010101011101
1000001010001000101010101000101
1010101010101011101011101011101
1010101010101010001000100010001
1110101010101110111110101110111
1000101000101000100010100010001
1011101111101011101010111011101
1010001000101000001010001000101
1011111010101011111011101011101
1000100010001010001010101010001
1010101111111010111010101010101
1010001000000010100010101010101
1011111111101110101110101010111
1000100000100000101010001010001
1110111010111111101010111011101
1010001010001000001010100000101
1011101011101011111010111110101
1000101000101000100010100010101
1011101110101110101110101011101
1000100000101000100010101000001
1010111111101011101010101111101
1010000000100010101010100010001
1011101110111110101010101010111
1010100010001000001000101010001
1010111011111011111111111011101
1000001000000000000000000010001
1111111111111111111111111111111
