1111111111111111111111111111111111111111111111111
1010100000100000100000001000100000000010000000101
1010101010101110101011101010111111101010101110101
1010001010100010101010000010001000001010100010101
1011101010101011101011111111101011111010111010101
1000101010101000001000100000101000100010001010101
1110111010111111111110101110101110101111111010101
1010000010001000100000101000101000101000000010001
1011111111101010101111101111101011101011101111111
1000001000100010001000100010001010101010001000001
1011101011111111111010101010111010101011111011101
1000100010000000100010001000100010100010000010101
1010111010111110101111111111101110101110111110101
1010100010100010001000000010000010101000100000101
1110111110101111111011101011111010101011101111101
1000100010101000001010001000001010001000001000101
1011101010101010101110111111101011111011111010101
1000001000100010100010101000100010000010001010001
1011111111111110111010101010111010111110101011101
1000100000000000100010100010001010000010101000101
1110111110111111101110111111101011111010101110101
1000100000100000100010001000001010000010101000101
1011101111111011111011101011101010111110101011101
1010001000000010000010001000101010100000101010101
1010101110101010111110111010111010101111101010101
1010100010101010100000101010100010101000001010001
1011101010101010101111101010101110101011111010111
1000101010101010101000000010000010101000000010001
1110101011101110101011111111111110101111111111101
1010101010001000101010000000001000100000101000001
1010111010111011101110111111101011111110101011111
1010100010001010000000000010100000100010101010001
1010101111101010111111111010111111101010101010111
1010100010001010100010000000100000001000101010001
1010111010111011101011111110101111111111101010101
1010100010001000001000000010101000001000000010101
1010101111101111111111111011101011101011111111101
1010001000001000100000001010001010001010000000001
1011111010101010101011111010111010111011111010101
1000100010101010101000001010100010001010001010101
1110101110101110101111101010101111101010101110101
1000100010100000100010101010000010001010100000101
1011111010111110111010101011111110111010111111101
1000001010001000001000100010000000100010001000101
1010111011101011111110111110111111101110101010101
1010000010001010000010001000101000100010101010001
1011111110111110111011101110101010111011101011111
1000000010000000001000000000100010000000001000001
1111111111111111111111111111111111111111111111111
