1111111111111111111111111111111111111111111111111
1000100000000000001000000000000000100000000000001
1110111111111011101011111011111110101110111111111
1000100000100010001000001000001010101010001000001
1011101110101110111111101111101010101011101011101
1000100010001010000010001000001000101010001000101
1110111011111011111010111011111011101010101011101
1010001010000010000010001010001000101010101010001
1011101011101010111111101010111110101010111010111
1010001000101000100000001010000010100010000010001
1010111110101111111111111010111010111011111111101
1010100000100000000000100010001000100000000010101
1010111011111111111110101111101111111111111010101
1010100010000000000010100010001000001000100000101
1010101111111011111010101010111110101010101111101
1010101000000010100010101010000010101010001000101
1010101011111110101110101011111010101111111010101
1010001000100010001000101010001000100010000010001
1011111110111010111011111010111111111010111011111
1000000010001010001000100010100000100010100010001
1011111011101011101110101110101011101110101110101
1000100000001000101010001000101010001000100010101
1010111110111110101011111011101010111010111110101
1010100010100010000000000010001010100010000000101
1010101011101011111111111010111010101111111111101
1010001010001010000000001010001000100000000000101
1011111010111010111111101111101111101111111111101
1000001000100010001000001000001000101000100000101
1111101111101111101011111011111010111010101110101
1010001000001000001000001010000010000010001010101
1010111011111011111111101011101111111111111010101
1010100010000010000000001000001000000010000000101
1010101110111110111111101111111011111010111111101
1000101000101000101000001000001010100010000000001
1111101011101011101011111010111010101011111111101
1000001000101000100010001010100010101000001000001
1010111110101110101110101010101110101111111011111
1010100010000010100000101010101000100000001000001
1011101011111010111111101011101011111110101111101
1000001010000010000000100010001010000010101000001
1011111010111111111110111010111010111011101011111
1000101000100000100010100010001010100000001010001
1110101111111010101010101111101010111111111011101
1010000000000010101010101010001010100000001000001
1011111111111110101010101010111010101111101111101
1000100010001000101010100010000010100010100000101
1010101010101011101010111111111010111010101111101
1010001000100000001010000000000010000000100000001
1111111111111111111111111111111111111111111111111
