1111111111111111111111111111111111111111111111111
1000100000001010000000001000001000000010000010001
1110101011101010111111101010101110101110101110101
1010101010101010100000100010100000101000101000101
1010111010101010101111111110111111111011101011101
1000100010101000100000000010000010000010100000101
1011101110101011111110111011111010111110111111101
1010001000101000000000101010001000100000001000001
1010111010101111111111101011101111101111111011101
1000100010100000100010000000000000001000000010101
1111101110111110101010111111111111111011111110101
1010001010000010101010100000000010000010000000001
1010111011111010101011101111111010111110111110111
1010000000001010001010001000000010100000100010101
1011111111101011111010111011111110111111101010101
1000000000101000001000101000100010001000001010001
1010111110101111101111101110101010101011111011101
1010100010100000100010000010101000101000001010001
1010101011111011111010111010111111101110111010111
1010101010000010000010100010100000100000100010101
1010101010111110111010101110101110101111101110101
1010001000100010100010100000101000100010001010001
1011111111101010111110111111101011111010111011101
1010000000001000100000100000001010000010100000001
1110111111111110101111101111111011111110111111111
1000100000000000101000001000001000000010000000001
1011111110111111101010111011101111111011111011101
1010000010001000001010100010001000000000001000101
1010111011111011111110101110111011111111101111101
1000101000000010100000100010100000100010000000001
1011101111111110101010111010111111101011111011111
1010000010001000001010101010001000001000100010001
1010111010101111111010101011101011111110111110101
1000100010100000100010001010100010001000100000101
1111101110111110101111111010111110111011101111101
1000100010001000100000000010000010100010000000101
1010111011101011101111111110111010101110111110101
1010001000001000100000000000100000100000100010101
1010111111111110111111111111101111111111101010101
1010000010000010100000000000100010000000001010101
1011101110101010101111111110111110111111111011101
1010100000101010101000000010000000100000001000001
1010111111101110101011111111111111101110101111101
1000001000100010101000100000100000100010100010001
1111101011111010101110101110101011101110111110111
1000001010000010100010100010001000001000100010101
1011111010111110111010111011111111111011101010101
1000000010000000000010000000000000001000001000001
1111111111111111111111111111111111111111111111111
