1111111111111111111111111111111111111111111111111
1000100000100010000000000010000000001000001000001
1110101110101110111111111010111011101110101111101
1010100010100010000000101000100010100010100000101
1010101010101011111110101111101110111010111110101
1000101010101000000010000000101000001000100010101
1011111010101111111011101111101011111111101110101
1010000010100010001000101000001000000000000010001
1010111110111110101010101011111011111111111011101
1000100010100000101010001000101000100000101000101
1111101110101111101111111110101110101110101011101
1000001000101000100000100010100000100010001000101
1011101011101011111110101010101111101011101110101
1000101000001000000010101000101000001010001000101
1010111111111011111010101111101110111010111011101
1010001000001010001000100000100010101010001000001
1011101011101010101111101110111010101011111111111
1010101000101000100000100010100010001000000000001
1010101011101111111110111110101110111111111011101
1000100010000000000010100000101000100000001010001
1111111010111011111110101111101110101111101010101
1000001010001010000000100000100010100010001010101
1011101111101110111111111010111010111010111010101
1000100000001000100000001010100010100010100010101
1010111111101011111011101010101111101110111110101
1010000000101010000010001010101000001000100000101
1011111110101010111110111110101110111110101011111
1000001000101000100010000010100000100010001010001
1111101011111111101011111010111110101011111110101
1000101000000000001000001010100010101000000000101
1110101111111110111011111010101011101111111011101
1000101010000010100010000010001000001000001000101
1011101010111010101010111111111011111011101011101
1010001010101010101010100000001010000010001010001
1010111010101011101110101111101110111110111110101
1010000010101000100010100010100010001000100010101
1011101110101110111010111010111011101011101010101
1000001000100000100010000010001000001000101000101
1011111011111011101011111110111111111110101111101
1010000010001000001000100000000000000000100010001
1010111110101110111111101111111111111111111011101
1010001000101010100010001000000010000000001000101
1011101011101010101010111110111011111011101110111
1000100000101000101010100000101010001000100010001
1110111111101011101010101111101010101110111011101
1000100010001000101000100010000010101000100010001
1011101010111111101111111010111110101011101110101
1000001010000000000000000010000000100010000000101
1111111111111111111111111111111111111111111111111
