1111111111111111111111111111111
1000100000001000100000001000001
1110101111101010111110101110101
1010001000100010001000100010101
1011111011111111101011111011101
1000001000001000101000100010001
1011111011101010101110101110101
1000100010100010001000100010101
1010101110111111111011111010111
1010001000000000001000101010001
1011111111111110101010101010101
1000100000100010101010100010101
1110101010101010101110101111101
1010101010001000100010100000001
1010101011111111111010111011111
1000101010000000001010100010001
1011111010111011111010111110101
1010000010001000001010001000101
1010111111101111101011101011101
1000100000100000100010001010101
1111101011111110111110111010101
1000001010000010101000000010101
1011111010111010101011111110101
1010000010001010100000000000101
1010111111101010111111111111101
1010100000101000100000000000001
1011101011101111101111111111101
1000001000101000100000000000101
1011111110101010111111111110101
1000000010000010000000000000101
1111111111111111111111111111111
