1111111111111111111111111111111
1000101000000010100000000000101
1110101010111010101110111110101
1010100010101010001010000010001
1010111110101010111011111011101
1000100000100010000000001000101
1011101111101110111111111110101
1010001000101000100000100010101
1010111110101111101110101010101
1010100000101000001000001000101
1010101011101011101111111111111
1010101010001010001000100000001
1010101110111011111010101111101
1000100000100010000010001010001
1111101111101010111111111010101
1000101000101000000000001010101
1010101010111111111111101010111
1010100010000010001000100010001
1110111111111010111010111011101
1000100010000010100010001000101
1010101010111110101111101011101
1010101010001000000000100010001
1010101011101111111111111110101
1010101000001000000000100010101
1010101111111011111110101010101
1010101000001000100010101010101
1011101010101110111010101010101
1000101010100010001010001000101
1010101110111011101011111111101
1010000000100000001000000000001
1111111111111111111111111111111
