1111111111111111111111111111111
1000100010000000000010000000001
1110101011101111101110101111111
1000101000101010001000100000001
1011101110101010111011111111101
1000100010100010001000100000101
1110111010111011101110101110101
1010001010100000100010101010101
1011101010111110101010101010101
1000100010001000101010101000101
1010111111101110101110101011101
1010000000100010101000001000101
1011111110111010101011111111101
1000100010001010100000100000101
1110111011101010111111101110101
1010001000101010001000001000101
1011101011101011111011111011101
1000101010001010001000100000001
1011101010101010101010111111111
1000100010101000101010000010001
1110111010111111101011111010101
1000100010000000101000001000101
1010101111101111101011111111101
1010100000100000001010001000101
1011111110111111111010101010101
1010000010001000001010100010001
1010111011101011111010111111101
1010001010001000000010100000001
1011101010111111111110101111111
1000001000000000000000100000001
1111111111111111111111111111111
