1111111111111111111111111111111111111111111111111
1000001000000000100000000000100000001000000000001
1111101011111110101111111010111110101011111011101
1000101010000010100010000010100010101010001000101
1011101010101110111110111110101010111010101110101
1010001010100010000010001000001000100010100010101
1010111010111011111010101111111011101110111011101
1010000010001000001010100010000010001000101000101
1011111111101111101010111010111110111011101110101
1000100000001000001010001010100000001010000010001
1010101111111010111010111010101111111010111011101
1010001000100010100010100010101000100010100000101
1011111010101111101110101011101011101110111111101
1000100010101000001000101010000010001010000000001
1110101110101011111111101010111110111010111111111
1000100010001010000010001010001000100000100000001
1011111011101010111010111111101011101111111111101
1010001010001000100010100010001000100000100000001
1010101011111111101110101010111110111110101111101
1010101000000000101000001010000010100010001000101
1010101111111011101111111011111010101111111010101
1010100000001000001000001000100010100000000010101
1010111111101111111011101010101110111111101011101
1010001000101000000010001010000010000000101010001
1011101010101111101110111011111011111110111010111
1010001010100000001010001010001010000000100010001
1010111010111111111011101110101110111111101111101
1000101010000010000000100010100010100000001000101
1111101011101010111110111010111010111110111010101
1000100010001010000010001010001000100010001010101
1010101110111011111011101011101111101011101010101
1010001010001000001010001000001000001000101010101
1011111011101111101010111111111110101110101010101
1000100000101000100010001000000010100010101010001
1110111110101010101111111011101011111010101011111
1010000010101010001000100010101000001010001010001
1011111010101111111010101110101111101011101011101
1000001000101000100010001000100010001000101000101
1011101011101010101111111110111010111110101110101
1010001010001010101000000010001010100000101000101
1110111010111010101111101011101010101111111011101
1000100010001010100000001010001010100010001000001
1011101111101010111111111010101010111010101111101
1000001000100010000000100010101010000010100000101
1011111110111111111110101110101011111110111011101
1000100000100010100000100000101010000010101000101
1110111010101010101111111111101010111010101110101
1000000010001000100000000000001000001000000010001
1111111111111111111111111111111111111111111111111
