1111111111111111111111111111111111111111111111111
1000000000100000001000001000000000001000100010001
1111111110111010111010101111101111101010101011101
1000000010001010100010100000001000100010001010001
1110111011101011101110111111111010111111111010101
1000100000101010001010000010000010000000101000101
1011111011101010111011111010101111111110101111101
1000001010001000000010000010100010000010001000101
1011101110111011111110111110111011101111101010101
1000100010001000100000100000101000100000000010101
1011111011101111101111101111101110111111111110101
1010000000100000100010100000001010100000001000101
1110111110111110111010111111101010101111101111101
1000100010100010000010000000100010001000101000001
1011101011101011111111111110111011111010101011111
1010001000001000000000000000100010000010100010001
1010111111111111101111111111101111101111111110101
1000100010000000100000100000001000001000001000101
1011101011101111111110101111111110111011101010101
1010001000001000000000101000000010100010100010101
1010111111101011111111101111101010101110111110111
1010100000001000100000001000001010001000001010001
1010111111111110101111111011111010111110101011101
1010000010001000101000101000001010100000100000101
1011111010101010101010101011101010111011111011101
1000001010101010101010100010001010000010001010001
1111101010101010101010101110111011111110101010101
1000101010100010100010101000101000100010100010101
1110101010111110111110101011101110101010111110101
1000101010100010000010101010000010101000100010101
1010101010101111111010111010111010111110111010111
1010101010100000001010000010001010000010000010001
1011101010101110111011111110111011111011111011101
1000000010100010000010100000100000101010000010001
1011111110111011111110101111101110101011111110111
1000001000101000000010001000100010001010000010001
1111101011101111111011101010111011101010111011101
1010001010000010001000101010000010001000101000101
1010111010111010101110101011111111111111101110101
1000100010001000100000101000100010001000000010001
1011101110111111111011111110101010101011111011101
1010101000100000001000000000101010101010100010001
1010101011101111101110111111101010101010101010111
1000101000101000101000100000001000100010101010101
1110101110101110101111101111111111111110101110101
1010100010100010100000100000100010000010100010101
1010111011111010111110111110101010111010111010101
1000001000000000000010000000001000100000001000001
1111111111111111111111111111111111111111111111111
