1111111111111111111111111111111
1010000000000010001000001000101
1010101111111010101110101010101
1010100000101010100000100010001
1010111110101010111111111111101
1010000010100000100010000010001
1011111010111111101011101110111
1000001010000010001000100010101
1111101111111010111110111010101
1000100000001000101000100010001
1010111111101110101011101111101
1010000000100010101010100010001
1111111110111010101010101010111
1000001000100010001010101000101
1011101011101111111010101111101
1010001010001000000010001000001
1011101010111010111110111011101
1000100010100010100010100010001
1010111010111110101110111011111
1010100010100000100010001000001
1010111110101111111011101011101
1010100010001000100000101010001
1010101011111010101110101110101
1010001000000010001000100000101
1011111011101111111110111111101
1010001010001000000010000010001
1011101011101011111011111010111
1000001000101010001010001010001
1111101110111011101010101111101
1000000010000000001000100000001
1111111111111111111111111111111
