1111111111111111111111111111111
1000100000000000101000000000101
1110101011111110101011111010101
1010101000001000100010000010101
1010111111101011101110111110101
1000100000001010000010100010101
1011101111111011111010101010101
1000101000001000101010101000101
1110101011101110101010101111101
1010001010000010100010100010001
1011111110111010101110111010101
1000001000100010100010101010101
1011101011111110101110101011101
1010100010001000101000100010001
1010111010101011101011101110101
1010100010100010001010101000101
1010101110111110111010101110111
1010000010101000101010000010001
1011111010101011101011111011101
1000100010100000001010001010001
1110111110101111111010101010101
1000100000100010001000101010101
1011101111111110101011101010101
1000001000000000101000101010101
1011111011111111101011101010101
1010000010000010001010001000101
1011101110111010111010111111101
1000101010001000100010100010001
1110101011101111111110101110111
1000001000000000000000100000001
1111111111111111111111111111111
