1111111111111111111111111111111111111111111111111
1000101000000010000010001000000000000010000000001
1110101011101010111010101011111110111011111011111
1010100000101010001000100000100000100000001000001
1010111110101111101111111111101111111111101011101
1010001000100000000010000010001000001000001010001
1011101111111111111110111010111011101111101110111
1000100000000010000000101010001000100000100010001
1110111111111010111111101010101011111110111011101
1000100000001000100000000010100010000010101010001
1010101111111111101111111111101110111010101010101
1010101000000010101000001000100010100000100000101
1010101011101010101110101010111110111111111111101
1010001010101000100000100010000010000010000010001
1011111010101111111111111111111010111010111011101
1000000010100000001000001000001010001010001000101
1011111110111111101010101011101010111011101110101
1000100000000000100010101000101010100010001000101
1110101011101111111110111110101010101110111011111
1010101000101000001000100000100010100000001000001
1010111110101011101011101111111111111111111111101
1000100000101000101010001000001000000000000000001
1011101111111110101010111011101010111110111111101
1010000000000000101010101010001010100010100000101
1011111111111111101010101010111010101011101110101
1000000010000000001010100010100010101010001010101
1111111010111111101010101110101110101010111010101
1010000000100010001010101000101010001010100010101
1010111111101011111010111011101011111010101110101
1000100000001010001010001000101000101000100010101
1011101111111010101011101110101010101111111010101
1000100000001000100000101000100010100000000010101
1111111110101111111110101011111110101110111110101
1000100010101000000000101000000010100010100000101
1010101011101111101111101111111010101011101111101
1010001000001000100010100010001010101010001000001
1011111110111010111010111010101010111010111011111
1000000010100010001000001000101000001010100010001
1111111010101111101111101111101111101010111011101
1000000010101010001000000000100010000010001010001
1011111110101010111110111110111011111111101010111
1010000000100010100010100010001000000010001010001
1011111110111010101011101011101111111010111011101
1000000010001010001000001010000000001000100010001
1011111011111011111111111011111111111111101110101
1000001000100010000000001010001000000000101000101
1111101110101111111011101010101011101111101011101
1000000010000000000010001000100000100000000010001
1111111111111111111111111111111111111111111111111
