1111111111111111111111111111111111111111111111111
1010001000000010001000001000001000000010001000001
1010101011111010111010101010111010111010101111101
1000101000101010000010100010100010100000101000101
1111101110101010111110111111101110111111101010101
1000100000101010100000100000100010000010000010001
1011111111101011101111101110111011111010111111111
1000000000001010001000100010001010100010100010001
1010111111101010111010111010111010101111101010101
1010101000001010000010000010000000100000001010101
1010101011111010111111111111111111111111101010101
1010100010100010001000100000000000000000101000101
1010111010101110111010101111111111111110101111101
1010001000100010100010001000000000001000100010001
1011101111111010101111111111111011111011111010111
1010100000000010101000000000000010000010000010001
1010111111111111101011111111111010111111111111101
1000100000100000001000100000100010101000000000101
1110101010111011111110101110101110101010111110101
1010101010001010000000100010101000100010100010001
1010101011101010101111111110101011101110101111101
1000101010100010100010000000101000100010100000101
1011111010111111111010111110101110111110101110101
1000001010000000001010001000100010000010101010101
1111101011101111101010101110111011111010101010101
1000101000100000100010100010001010100010101010001
1110101110111110111110111011111010101110101011111
1000100000100000100010001000000000100000101000101
1011111111101111101011101111111111111111101010101
1000000000001000101000101000000010000000100010101
1011111110111011101110101011101110111011111110101
1010001000100000001010100010001000101010000010001
1010101011111011111010111011111011101010101111101
1000101010001000000010000010000010001000100000101
1111101010101011111011111110111111101111111110101
1000101000101010001000100010100000001000000010101
1011101111101110101110101110101110101010111010101
1000100010100000100010001000101000101010001010001
1010111010111111111011111011101011101011101111111
1010001010000010001010000010001000101000100000001
1010111010111010101010111111111110101110111011101
1010000010001010101000100000000000101010001010001
1011111110101110101111101110111111101011101010111
1000000010100000100000001000101000101000001010101
1111111010111110111111111011101010101011111010101
1000001010100010000010001000101010101010001010101
1011101011101011111110101110101010101110101010101
1000100000001000000000100000100010000000100010001
1111111111111111111111111111111111111111111111111
