1111111111111111111111111111111
1000100010001000000000001000001
1110101010101011101111111011101
1010101010100010100010000000101
1010101010111110111010111111101
1000101000100000101000100000001
1011111011101110101111101111111
1010001000001000100000100000001
1010101111111011111010111111101
1000101000000010001010100000101
1111101110111110101110101110101
1000100010000000100000101000001
1110111011111011111111101111101
1000001000101010000000101000101
1011111110101010111110101010101
1000100000100010100000001010101
1010101111111110111011111010101
1010101000000010001010000010101
1010101111101011101110111110101
1010001000001000100000100000101
1011111011111110101111101111101
1010001010000010100010001000001
1010101011101010111110111011111
1000101000101000100010100000101
1111101110101111101010111110101
1010001000101000001010000010101
1010111011101110111011111010101
1010100010100000101010000010001
1010111010111111101010111111101
1000000010000000000000100000001
1111111111111111111111111111111
