1111111111111111111111111111111
1000101000000000000010100000001
1110101011101011111010101011101
1010100000101010001010001000101
1010111111101110101011111110101
1010000000100000101000100000101
1011111110101111101110101111101
1010000000101000001010001000101
1010111111101011111011111010101
1000100010101000100000100010001
1011101010101110101011101111111
1000001010000010101010001000001
1111111011111010101110111110111
1000000010001010100010100010001
1011111110101110111010101011101
1000100000100010001010001000101
1110111011111010101011111110101
1010000010100010101010000000101
1011111110101111101010111111101
1000000010001000001010000000001
1011111010111011111011111111101
1010000010001010000010000000001
1110111111101010111010111111111
1000100000100010001010100010001
1010101110111111111010101010101
1010100010000000100010101000101
1011111011111010101010111111101
1000001000101010001010100000001
1011101110101011111110101111101
1000100000001000000000001000001
1111111111111111111111111111111
