1111111111111111111111111111111
1000100000000000100000100000001
1110111011111110101110111110111
1010000010000010101000000010001
1011111110111010101111111011101
1000000010001010100000100010001
1111101110101010101110101110101
1000001000101010100010100000101
1011111011101110111010111111101
1010000010100000100010001000001
1010111110111111101111101011111
1010000000100010000000101010001
1011111110101110111110101011101
1000001000100010100010101000101
1110101011101010101011101110101
1000101010101000101000001010101
1011111010101111101111111010101
1010000010001000001000000010101
1010111111101011111111101110101
1000100000101000000000100010101
1011101110101111111010101010101
1000101000101000001010101010101
1110101011101011101010111010101
1010001010001000101010100010001
1011111011111110101110101111101
1000001010000000100000101000101
1011111010111111111111101010101
1000000010100000100000001010101
1011111110101011101011111010101
1000000000101000001000000010001
1111111111111111111111111111111
