1111111111111111111111111111111111111111111111111
1010001000001000001000000000000010001000000000101
1010101110111010101010101111111011101011101110101
1000100010100010101010101000100000001000101010001
1111111010101110111010111010111111101011101011101
1010000010100010100010000010001000001010001000001
1010111110111010101111111111101111111010111111111
1010000010000010100000100000101000001010000010001
1011111010111110111110101010101011101011111010101
1000001010101000100000101010100000100000101010101
1010111010101011101111111011111111111110101010101
1010000010001000100000001000100010000010001000101
1011111111101110111111101110101010111011111110101
1000000000100010000000101000101000101000000010101
1111111110111111111110101011101111101111111011101
1010000000100000000010101010001000100010000010001
1010111111101111111010101010111010101010111110101
1010001000001000000010001010100010101000100000101
1011101011101011111110111010101110101111111011101
1010001000101010000000000010000010100000000010101
1010111110101011111111111011111010111111111110101
1010001000101000000000100010001010100010100000001
1011101111101111111110101110101010101010101111111
1010001000101000000010100010101010001010100010001
1010111010101011111010111110101111111010111010101
1010100010101000100010100000100000100010000000101
1010111010101111101110101111111110101111111111111
1010000010001000101000101000000010100000100000001
1011111111111010101011101111111010111010101111101
1000000000000010001010000010001000001010000000101
1011111011111111111011111010101111101111111110101
1000001000001000100010001010100000100000001000101
1111101111101010101110101010111110111111101111101
1000100010101010100000101010001000100000101000001
1011111010101010111111101011101011111110101011101
1000001000100010001000001000001000100000101010001
1010111110111110111011111111111110101111101011111
1010000010001000100010000000100000101000001010001
1011111011101011101110111110101111101011111010101
1010001010001000100000101000100010001000001000101
1010101010111110111111101011101010111111101111101
1000101010000010000000001010001010000000101000101
1110111011111011111111101011111010111010101010101
1000100000001010000000100010001010101010100010101
1011101111101011111010111110101010101011111110101
1010100000101000000010000000100010101010000010001
1010111110111111111111111111111110101010111011101
1000000010000000000000000000000000001000001000001
1111111111111111111111111111111111111111111111111
