1111111111111111111111111111111
1000100010000000000010000000101
1110101010101111111110101110101
1000101000100000000000100010101
1011101111111111111011111010101
1010001000000010001000001010001
1011101011101110101111101011101
1000100010101000101000101010001
1110111110101011101010111010111
1010001000001010001010001010101
1011101011111010111011101010101
1000101000100010001010001010101
1010101111101111101010111010101
1010100000001000100010000010101
1011111111111011111111111110101
1000000000100000001000100010001
1110111110101111101010101011101
1000100010100000100010001000001
1011101110111110111111111111111
1000100010101000100000000010001
1010111010101011111011111011101
1010001000001010000010001000101
1011101111101011101110101110101
1000100010001000100000101010101
1110111010111110101111101010101
1010001010100000101000101000101
1011101011101111111010101011101
1000101000101000001010001010001
1011101110101011101011111010101
1000000010000010000010000000101
1111111111111111111111111111111
