1111111111111111111111111111111
1010000000100000000010000010001
1011101110101111111110101110101
1010001000100000000000100000101
1010111011101111111111111110101
1000101010100010001000000010101
1111101010111010111011111011101
1000100010001010001000001000001
1010101110111011101111101111101
1010101000100000000010100010001
1110101010101111111010111011111
1000101010001000100000100010001
1010101110111010111111101010101
1010100010100010000010001010101
1011111010101111111010111110101
1000100010101000100010000010101
1010101111101110101110111010101
1010001000100010101000001000101
1011111010111010101111101111101
1010000010000010100000100010001
1010111111111110111110111010101
1010000010000000100010001010101
1011111010111110101111101110101
1000000010001010101000001000101
1111111111101010101011111011101
1000000000001000001000100000101
1011111011111111111110111110101
1010100010000000100000100010101
1010101110111110101111101010101
1000100000000010000000001000101
1111111111111111111111111111111
