1111111111111111111111111111111111111111111111111
1010001000000000000000000000000010100000001000001
1010101011111111111011111111111010101111101010101
1010101000001000000010000010001010101000100010101
1010101011111011111111101010101010101010111110101
1000101010000010000000001010100010101010001000101
1111101110111111101110111110111110101011101011101
1000100000101000001000100000100000101010001010001
1010111111101010111111101111101011101010111011111
1010001000000010000000101000001000100010001000001
1011101011111111111110101110111110101111101111101
1010001000100010000000100010100010001000100010101
1010111110101010111111111011101011111010111010101
1010100000101010000000001000001000000010001000101
1011101111101011111111101111111111111111101111101
1010001000001010000000100000000010000000100010001
1010111111101110111110101111111110111010111010111
1000100000100000100010101000100000100010100010001
1011111010111110101010101010101111101111101110101
1010000010000010101010100010001000100010001000101
1010111111111011101010111111111110111010111011101
1000100010001000001010001000000000001010100000101
1111101010111111111010101011101111111010111110101
1000001000100000100010101000100010000010000010101
1011101110101110101110101110111010111111111011101
1010001000100010001000100000100010000000001010001
1010101111111011111110111111101011111111101010111
1010101000000010000010100000001000100000101010001
1010111011111111101011101111111110101111101011101
1010001000100000001010001000000010101000001010001
1011101110111110111010111011101110101011111010101
1010100010001000101010001000100000001000100010101
1010101111101011101010101111111111101110101110101
1000100000100010100010100000100010000010001000101
1111111110111110101110111110101010111111111011111
1000100000100000100010001000101010100000000000001
1010101110101110111011101011101011101111111110101
1010001010100010001000101000001010001000000010101
1011111010111010101110111111111010111011111011101
1000001000001010100010100010000010101000101010001
1111101111111010111110101010111110101110101010101
1000001000000010000000101010000000001000101000101
1011111011111111111111101011111111111011101111101
1000100010000000101000001000001000000010001000001
1110101111111010101011101111101011111110101011111
1000101000000010100000101000101000101000101000001
1011101011111110111111101010101110101010111111101
1000000010000000000000001010000000100010000000001
1111111111111111111111111111111111111111111111111
