1111111111111111111111111111111
1010000010000000000000001000001
1011101010111111111111101111101
1010001000100000000010100000001
1010111111101111101010111111101
1000100000101000001000000000101
1111101110111011111110111111101
1010000010001010000000100010001
1010111011101011111111101010111
1000101000100010000000001010101
1011101110101110111111111010101
1010000010101000100000001010001
1011101110101011111011111011101
1000101000101000000010000000101
1110101011101111101110111011101
1010101000101000101000100010001
1010101110111010101011101110111
1010100010100010001010001000101
1010111010101111101010111011101
1010100010101000101010001000101
1010101010101010111011101110101
1000101010001010000010001000101
1011101111111011111110111011101
1010100010001010001000100010001
1010101010101010101111101110101
1010001000101000100000100000101
1011101111101111111110111111101
1000101000000010000010000000101
1110111011111011111011111011101
1000000010000000000000001000001
1111111111111111111111111111111
