1111111111111111111111111111111
1000000000101000000000100000001
1111111110101011101110111110101
1000000010100010101000000000101
1011111010101110101011111111101
1010001010101000101000100010001
1011101010101010101111101011101
1000101000101010101000101000101
1110101111101010101010101110101
1010101000101010101010001000101
1010101010101011101011111011101
1010100010101000100000001010101
1010111110101110111111111010101
1000100000101000100000001010101
1011101111101010101111101010101
1000101000001010100010100010101
1110101011111010111010111110101
1010101010000010100010000010001
1010101011101011101110101010111
1010101000101010001000101010101
1010101110111010111111101110101
1010100000000010100000001000101
1010111111111010101011111011101
1010001000001010101010000010001
1011101011101110111010111111101
1000101010100010100010100000001
1110101010111010101110111011101
1000101010001000100000100010001
1011101010101111101111101110111
1000000010100000000000001000001
1111111111111111111111111111111
