1111111111111111111111111111111
1000100000000010001000000000001
1110101111111110101011111111101
1000101000100000100010001000001
1011101010101111111010101011101
1010001010000010001010101010001
1011101011111010101010111010111
1010001010001010101000100010001
1010101010101110101111101111101
1010101010100000101000001000101
1010111010111111101011111011101
1010000010101000100010001000001
1010111110101010111110111011111
1010100010100010001000001010001
1011101010101111101011101011101
1000001000101000100010001000001
1111111111101110111110111111101
1000001000100000100010100000101
1011111010111110101010101110101
1010000010001000101010001010001
1010111111101011101111111011111
1010000010001010100000001000001
1011101110111010101110101111101
1000101000100010001000100000101
1011101011101111111011111110101
1000001000101000001000100010001
1011111110101010101110101111101
1010001010001010100000100000001
1010101011111110111111101111111
1000100000000000100000000000001
1111111111111111111111111111111
