1111111111111111111111111111111
1000100000100000000000100010001
1110101110101111101110101011101
1010001010101000101000101000101
1011111010101011101011101110101
1000001000100010001000001000101
1110101011111110111111111011101
1000101000001000100010001010001
1011111111101011101010111011101
1010000010001000001010001000101
1010111010111111111011101110101
1010101000100000100010000010101
1010101111101110101110111110101
1010100000001000100010100010001
1010101111101011101010101011101
1010100010001010101010001000101
1010101110111010101010111011101
1010101000101010001010001000101
1010101011101011111011101110101
1000101010001010001010001000101
1011101010111010101010111011101
1010001010001000100010100010001
1011111011101111111111101010111
1000001000101000000000001010101
1111101110101011111011111110101
1000101000100010000010000010001
1011101011101110111110111011101
1000001010001010100010001000001
1011111010111010101011101111111
1000000010000010001000000000001
1111111111111111111111111111111
