1111111111111111111111111111111111111111111111111
1010100000000000001000000000000000001000000000001
1010101011111111101110101111111111101011111111101
1010001010000000100010100000001000101000000010001
1011111010111110111010111111101010101011111011111
1000001000100010101010000010001010001010001000001
1111101110101010101011111010111011111010111111101
1000100010101000100010000010100010001010001000101
1011111010101111101111111010101110101011101010101
1000000010100000100000001010100010101010001010001
1011111110111110111111101110111010101010101011101
1000000010001010000010100000100010100000101010101
1111111011101011111010111111101111111111101010101
1000001010000000100010001000001000001000101010101
1110101011111110101110101011111110101010111010101
1000101000100010101000101010000000100010001010001
1011111110101011101011101010111111111111101011101
1010001000101000001000100000100000000010001000101
1010101011101111111110111111101110111010111110101
1000101010000000100000001000101010001010001000101
1011101010111110111111111010101011101011101011101
1000100010100010000010000010100010001000101010101
1110111110101011111010111110111010111111101010101
1010000010101000100010001010100010100000101010001
1011111010101110101011101010111110101110101011111
1000100010101010101010000010100010001000101010001
1110101111101010101110111110101011111011101010101
1000100000001010100000100000101000001000000010101
1011111111111010111011101011101111101111111110101
1000000000000010001010001010001000101000000000101
1011101011111011101010111010111011101011111111101
1010001010001000101010001010001010001000100000101
1010111110101111101011101111101010101110101111101
1010000000100000101010100000000010100010001000101
1111111111111110101010111111111010111111101010101
1000000000000000101000001000001010000000001010001
1011111110111111101011111011101011111111111011101
1000001000100000001010000010101000100000100010001
1011101111101111111010111110101110101111101111111
1010101000001000001010100000001010001000101000001
1010101011111010111010111011111011101010101011101
1000101000100010100010001000100000001010100010001
1111101110111010101111101110111111111010101110101
1000000010001010000000101010000000100010101010101
1011111111101111111111101011111110101110101010111
1010000000101000000000001000100010100010100010001
1010111011101011111111111011101010111010111111101
1000001000000010000000000000001000000010000000001
1111111111111111111111111111111111111111111111111
