1111111111111111111111111111111111111111111111111
1010000000100000000010001000000000000000000000001
1011101110111111111010101011111111111011111111101
1010001010001000001000101010100000001010001000001
1010111011101011101011101010101111101010101111101
1000100000100010001010001010100000101010100000101
1111101110111110111010101010111110101010111110111
1000101010000000100010101010000000101000100010001
1010101011111111101110111010111111101111111011101
1010101000000000100010000010000010001000000000101
1011101110111011111011111110111110101110111110101
1000101000100010000010000000100010100000100010101
1010101011111110111111111111101010111111101011101
1010101000000000100000000000001000100000101000101
1010101111111011111011111111111011101110101110101
1010100010001010001010001000000010001010001010101
1110111010101010101010101011111110111011111010101
1000100010101000100010100000100000100010000010101
1011101110101111111110111111101111101010111010101
1000101000101000000010100000001000001010100010101
1110101010101111101110101111111110111011101010101
1000101010101000101000101000000010101010001010001
1011101010101010101011101010111010101010111111101
1000101010100010100010001010100000100010001000001
1010101010111110111110111110101111111011101011111
1010001010101000100010100010100010001000101010001
1011111110101011101010101010111110101110101010101
1000000000101010001000101000100000101000001010101
1111111111101011101111101111101111101011111010101
1000000000001010001000000000100010101010000010101
1011111111101010111011111110111010101110111110101
1010100000101000101010001000001000100000100000101
1010101110101111101010101011111110111111111011101
1010100010000000001000101000000000100000001010001
1010101111111111111111101111111111111011101110101
1010001000000000000000101000000010000010000000101
1011101011111111111110101110101010101111111111101
1000101010100010001000100010101010100000001000001
1010111010101010101011111010101011111111101011111
1010000000101000100010001010101000000000101000101
1011111111101111111010101011101111111110101110101
1000100000001000001010101010001000100010101010001
1111101111101011101110101010111010101010101011101
1000001000101010100000101010001010101010001000101
1011111011101010111111101011101011101011111010101
1010001000001000100000001010001010001000000010101
1010101111111110101111111010111010111011111111101
1000100000000000100000000000100000001000000000001
1111111111111111111111111111111111111111111111111
