1111111111111111111111111111111111111111111111111
1000000000000000101000001000100000000000100000001
1111111111111110101010111010101110111110111011101
1000000000001000100010000010000010100000000010101
1011111011101011101111111111111010111111111110101
1010000010001010000010100000100010000010000010001
1110111110111011111010101110101111111011111010111
1000101000001000001000101010101000001000001000001
1011101011111111101111101010101011111111101111111
1010000000100000100010001000101000100000100000001
1011111110101110111010111011101010101011111111101
1010000010100010001000101010001010001010000000101
1010111010111010101111101010111111101010101110101
1000100010001010101000001010100000101000101010101
1011101110111010111011101010101110111110101010101
1010001010100010000000101010001010100010101000101
1110111010101111111111101011111010101011101111101
1000101000101000101000101010000000101000001000001
1011101011101010101010101010111110101111101011101
1010000010000010001010001010100010101000101000101
1011101110111110111011101011101010101011101110111
1000101000100010100010001000001010001000000010001
1010111011101011101110111111111011111011111011101
1010001010101000001010101000001010000010001000101
1111101010101111111010101011101011111110101111101
1000101010100010000000001010001000100000100000001
1010101010111011111011111010111110101111111111101
1010101000101000001010100010000000101000101000001
1010101110101111101010101111111111101010101011111
1010100010000000101000100010001000000010101000001
1010101011111011101011111010101111111110101111101
1010101000000010001010001000101000000000100000101
1010111111111110111110101111101011111111101011101
1010000000000000100000100000101010000000101000101
1011111111111110101111101111101010111111101110101
1010100000000010101000100000001010000000001010001
1010101010111110101110111111111010111111111011111
1010001010100000101000000010000010100000100000001
1010111011101111101011111010111110111010101110101
1010101000000000100010001000100010000010100010101
1010101111111111111110111111101111111110111010101
1010000000001000000000000000100000001000101010101
1011111011111011111111111011101110101011101010101
1010000010000010000000100010001000101000101010101
1011111110111111111011101110111011111110101010101
1010000000100010001000100000101000000000100010101
1010111111101010101110111111101111111111111110101
1000000000001000100000000000000000000000000000101
1111111111111111111111111111111111111111111111111
