1111111111111111111111111111111
1010001000000000100000100010001
1010101011101111101011101010101
1000101010100010001000001000101
1111101010111010111111111111101
1000101000001010001000001010001
1010101111101011101110101010101
1010001010001000100010100010101
1011111010111010111010111110101
1010001010100010001000100010101
1010101010101111111110101010101
1000101000100000000000101010101
1111101110111111111111101010111
1000100010001000000000001010001
1110111011111011111111111010101
1000001000000010000000100010101
1011111111111110101111101110101
1000000000100010100000001010101
1011101110101010111111111010101
1010101000001010000000100000101
1010101111111111111110111111101
1010101000000000001010000010001
1010101011111110101011111010111
1010100010000010100000001010001
1010111110111010111111101010101
1000100000100010100010001010101
1111101111101110101011111011101
1000001000000000101000001000001
1011111111111111101111101111101
1000000000000000000000100000001
1111111111111111111111111111111
