1111111111111111111111111111111111111111111111111
1010000000000000000000100010000000100000001000101
1010111111111111111110101010111011101011101010101
1010000000100000001000101010001010001010101010001
1011101110101111101111101011101010111010101011101
1000100010000000100000001000101000001010001000101
1110111111111011111111111110101111111010111010111
1010000000001010000000100000100010100010100010001
1011111111101010111110101111111010101110101111101
1000100010001010100010100010001010101010100000101
1011101010111110101110111010101010101010111111101
1010001010100000100000001000100000101010100000001
1010111010111010111111101111111110101010101111101
1000101000100010100000100000000010101000101010001
1011101111101111101110111111111011101011101010111
1010000010001000000010001000001000001010001000101
1010111010101011111111101011101111111010111110101
1000101010100010000010001000100000100010100010001
1111101010111110111010111110111011101110101011101
1000001010100000101000100000001000101000001010001
1011111010101111101111101111111010101111111010111
1000000010100000100010000010001010100000001010001
1011111110111110101011111110101110111111101011111
1000001000000010101010000010101000100000101000001
1111101111111110101010111010101011101110101011101
1000100000000000101010101010101000101010001000101
1010111111111111101010101010101110101011111111101
1010000010000010001000101010101000101010000000101
1011101110111010101111101010101011101010101110101
1010001000101000100000100010100010001010101010001
1010111011101111111010101110101110111010101011101
1010001000100010001010101000101000100000101010001
1111101110101110101110101010111011111111101010111
1000000010101000101000101010001010000000001000101
1011111010101011101011101111101010111111111011101
1010000010001010000010000000001010000010100010001
1011111111101011111110111111111010111010101110101
1000000000101000001000101000100010100010100010101
1011111110101111101011101010101111101110111010101
1010000010001010001000001010100000001000001010101
1010111011111010111111101010111111111110101010101
1010101000000010000010001010000000000010101010101
1010101111111011111011111010111111111011101010101
1010100000100010001000000010000000100000001000101
1010101011101110101111111111111110111111111111101
1000101010001000100000100010000010001000100000101
1111101010111011111110101011101011101010101110101
1000001000000010000000001000001000100010000010001
1111111111111111111111111111111111111111111111111
