1111111111111111111111111111111111111111111111111
1010001000000000100000000010001000001000100000101
1010101011111110101011111010101110101010101010101
1010101000100000101010000000100010101010001010001
1010101110101111101011111111111010101011111011101
1000101010100000001000100000001000101000001010001
1111101010111111111110101111101111101111101011111
1010001010100000100010001000101000100000101000001
1010111010101110101111111010101110111110101111101
1000100000101000001000001010100010000010101000101
1011111011101111111011101010111011111010111010101
1000001000100000001000100010001000001010000010101
1111101110111111101011111111101111101011111110101
1000101010000000100010000010001000101000000000001
1011101011111110101110111010111010101111111111101
1010001000000010101010100000100010101000000000101
1010111111101110101010111011101110101011111110101
1010001000100000100010001010001000100000100010101
1011101010111011111110101010111110111110101110101
1000101010001000000010101010000010000010100010101
1110101011101111111011101011111011111010111010111
1000101000100010000000001010001000100010000010001
1010101110111010111111111010111110111011111011101
1010100000100010100000001000100010001010000010001
1011111111101111101111101111101011101011111010111
1000100000101000001000100000001010001010001010001
1010101110101110111011111111111010111010101111101
1010001000100000101000000000100010001010100000001
1011111011111111101010111111101111101010111111101
1010001000000000101010000010001000001000101000001
1010101111101110101011111010111011111111101011111
1010100000001000001000001010100010001000001010001
1010101111111011111011111010101110101010111010111
1010101000001010001010000010001000100010100010001
1010101011101110101010101111111011111110101111101
1010101010001000101010101000000000000010100000101
1110111010111011101010111011111111111010111110101
1000100010100010101010000010000000101010100010101
1010101110101110101011111110111110101010101010101
1010101000101000100010000000100010001010001010101
1011101011101010111110111111101111101011111010101
1000001000001010000000001010000000001000001010101
1011111111111011111111101010111111111111101110101
1000001000000000001000001010100000001010001000101
1111101011111111111011111010101111101010111011101
1000101010000010001000101000101000101010001010001
1011101110111010101110101011101011101011101010101
1000000000100000100000100000001000000000100000101
1111111111111111111111111111111111111111111111111
