1111111111111111111111111111111111111111111111111
1000000000100000000000100000000000000000001000001
1111111110111110101110101111111111101111101011101
1000000010000010100010101010000000101000101000101
1011101111111011111011101010111110101110101110101
1010001000001000100010001010100000100000100000101
1010111011101110101110111010101111111110111111101
1010001010100000100010000010100000001000001000101
1011101010111111111011111010111111101111101011101
1010001000001000000010000010101000101000101010001
1010111111101011101110111110101010101010101010101
1010000000001000101000100000101010001010100010101
1011111111111111101011101111101011111010111010111
1000100000100000100010001000001000100010100010001
1110111010101110111110111011101110101010111110101
1010000010101000000010100010100000101010000010101
1011111110101111111010101110111111111011111011101
1000000010100010001000101000100000001010000010001
1011111110111010111111101010111110101010111110101
1010001000100010001000100010000000100010001000101
1010101011101110101010111111111111111111101110101
1010100010001000101010000000100010000000100000101
1010111111101011101011101110101010111011111111101
1010000010001010101010101000101010101000001000001
1011111010111010101010101110111010101111101011111
1010000010001000100000100010000010100010001010001
1010111111101111111111111010111110111010111011101
1010000010001000000000100010100000100010000010001
1011111010111011111110101110101111101111111110111
1010001010001010000010001000101000000000000000001
1010101011101011101111111011101011111111111011101
1010100010001000101000000010001000001010001000101
1010111110111110101011111110111111101010101111101
1010100000001000100010000010001000100010100000001
1010111111101011101110111011101011101110111111111
1010100000001010001000101000001000001000100000001
1010101111111011111011101111111111101011101111101
1010101000000010000010000000100000101010001000101
1010101010111110111110111110101110111010111011101
1010001010100000100000001000101010100010100000101
1011111011101111111110101011101010101110111110101
1000100000001000000010101010001000100010100010101
1010101111111011101011101010111011101010101010101
1010101000100010001000101000100010001000001000101
1011101010101110111110101111101111111111111011101
1000001010000010101000100010101000000010001010001
1011111111111110101011111010101011111010101110101
1000000000000000100000000010000010000000100000101
1111111111111111111111111111111111111111111111111
