1111111111111111111111111111111
1010000010000000001000000000001
1011101011111011101111101111101
1010001000000010101000100010001
1010111111111110101010111010111
1010100010000000001010000010101
1010101011101111111011111110101
1010001000100010001000000010001
1011111010111010111011111011101
1000001010001010100010001010001
1111101111101010101110111010111
1000101000101010000000100010001
1011101010101011111110101111111
1010001010101000001010100000001
1010111010101111101010111111101
1010100010001000101010100000101
1010111011111011101010101011101
1010001010000010001000101010001
1011101010101110111011101010111
1000100010100000101010001010001
1011111110111111101011111011101
1000001000100010100000000010001
1010111011101010101111111110101
1010000010001010101000000000101
1011111110111010101011111111101
1000001000100010001000100000101
1111101110101111101110101011101
1000100010101000100010101010001
1010111010101010111110101010111
1010000000100010000000101000001
1111111111111111111111111111111
