1111111111111111111111111111111
1000100000000000001000100000001
1110111111111011101110101011101
1010100000001010000000101000101
1010101111101011111111101110111
1010001010001000000010001010001
1011111010111011111010111011101
1000100000100000001000000000101
1011101111111111111111111111101
1010001000000010000000001000001
1010111011101010111111101011101
1000100000101000101000001010001
1011111111101111101011111010111
1000000000001000001010000010101
1111111111111011101010111110101
1000000000101000100010001010001
1011111110101110111111101011101
1010000000100010100010001010001
1011111110111010101010111010111
1010000010000010101000100010001
1010111011111010101111101111101
1000101000100010001000000000101
1011101110111011111011111011101
1010100010001000001000001000001
1010101011101111111111101111111
1010101000100000000010001000001
1010101110111111111010111011101
1010000010001000001010100010001
1011111110101110101010111010111
1000000000100000101000000010001
1111111111111111111111111111111
