1111111111111111111111111111111111111111111111111
1000100000100010000000000000000010000010000000101
1110101010101010101111111111111010111010111010101
1000101010101000100000001000001000100010100010001
1011101010111111111110101110101111101111101111101
1000101010100000000010100010100000100010001000001
1110111010101111111011111010111011111010111111101
1010000010001000001000000010101000000010000000101
1011111111111011111111111110101111111110111110111
1000000010001000100000000010001000000000100010001
1011111010101010101011111111101011111111101010101
1010000000101010001000000000101010000000101010101
1010111111101011111110111011101110111110101011101
1010100000101000100010001000100010100010101000101
1011101110111110101011111110111010101010101110101
1010001000100000101010001000100010101010001010101
1010111010101111101010101010101110111011111010101
1010101010100000101000100010101000001000000010001
1010101011111110101111111111101011101011111111101
1010101000000010100010000010001000101000000000101
1010101111101110111010111010111110101111111011101
1000100000100000001000001010100000100010000010001
1011111110111111111111101010111110111010111110111
1000100000000010000010001010000010101010000000001
1110101111111010111011101011111010101010111111101
1010101000001010001000101010001010001010001000101
1010101011101111101110111010101010111010111010111
1000100010101000100010001000101010100010100010001
1011101110101010111011101011101011101111101111101
1000100000101010001010101010001000100000001000101
1110111110101010111010101110101110111011111010101
1010100000100010001010100000100010001000000010101
1010101111111111101010111011111011101111111111101
1000100000101000001010001010001000100000100000001
1011111110101011101010111010101111111110101111111
1000001000001010001010001010101000000010100000001
1111101011111011111010101010101011111010111011101
1000101000100010000010100010100010001010001010001
1010101110101110111011111110111111101011101010101
1010101000100010001010000010001000001010001010101
1110101111101011101110111011101011111010111110101
1000101000101000100010101000101000001010100000101
1010101010111010111010101010101111101010111011101
1010100010000010101010001010101000101010001010001
1011111111111110101011101011101010101011101010111
1000000000000010001010001000001010101000101010101
1011101111111111101010111111111010101011101010101
1000100000000000001000000000000010001000000010001
1111111111111111111111111111111111111111111111111
