1111111111111111111111111111111111111111111111111
1000100000001000000000000010001000000000100010001
1110101111101110111110111010101011111110101011101
1000101000100010000010001000101000001000001010001
1011101010111011111011101111101110101111111010101
1000101010001000001000101000100010100000101000101
1110101110101111101111101110111011111110101111101
1010100010100000000000101000001010000010100000001
1010101011111011111110101011111010111010101111111
1000101000001010000010001000000010100000100000101
1011111111101110111011111011111110111111111110101
1000000000100010101010000010000000000000000010101
1111111110101010101010111110111111111110111010101
1000100000101000001010000010000010000010100010101
1010101111111111111011111010111110111011101110101
1010001000000000001010000010100000101000001010101
1011111010111111101010111110101111101111111010101
1000100010100010000010100010100010001000000010001
1110111011101011111110101110111010101011101011101
1010100010001000001000100000100010100010001010001
1010101010111111101011111111101111111110111010111
1000101010000000101010000000101000000000100010101
1011101111101111101010111110101010111111101110101
1000100010001000101000100010001010100000001000101
1110111010111010101111101011111010111110111011101
1010001000100010001000001000001010000010100010001
1011101111101111111111111011111011111011101111101
1000100010001000000000000010000010001010001000001
1110111010111011111111111110111110101010111011101
1000100010100000001000000000100000101000100000101
1010101110101111101011111111101111101111111110101
1010101000100000101000100000101000100000000000101
1010101110111111101110111110101110111010111111101
1010100010001000100010000010000000001010100010001
1011111011101010111011111010111111111010101010111
1000001010001010000000100010001000000010101010001
1111101010111011111111101111111010111111101011101
1000001010100000100000001000000010100010001010001
1011101010111110101111111010111111101010111010111
1000101010000010001010000010100000001000001010001
1110111010111010111010111011101111111111111011101
1000100010001010001000001000000000100010000010101
1011101111101011101111101111111110101110111110101
1010001010001010100010000000100010101000100000101
1010111010111010111011111111101010101011101110101
1010001000001010001000000000001010001010001000101
1011101111111010111111111111111011111010111111101
1000000000000010000000000000000000000010000000001
1111111111111111111111111111111111111111111111111
