1111111111111111111111111111111111111111111111111
1010000000000000100000001000000000001000000010001
1011101011111110101111101111111011101111111010101
1010001010000010101000101000001010100000001010101
1010111110111010101010101011101010111111101010101
1010000000100010001010101000100010000000101000101
1011101111101111111010101110111110111011101011101
1000100010001000001010100010000010101010001010001
1110111010111011101011111011111010101010111010101
1000100010001010001000001000000010101010001010101
1011101111101011101111101111111110101011101110101
1010000000101000100000001000100000101000100000101
1011111011101010111111101010111011101110111111101
1000100010001010001000100010100010000010101000001
1110101110111011101011111110101111101110101011111
1000100010100000101000001000100010001000101010001
1011111010111011101011101011111010111011101011101
1010000010001010001000101010000010001010001000101
1010111111101010111110101010101111101010101110101
1010001000001010001000100010100000101000100010001
1011101011111111101011111111101110101111111011101
1010001010000000001000000000100010100000001010101
1011101011111011111111111110111010111011101010101
1000101000100010000000101000101010001010100000101
1110111110101010111110101011101011101010111111101
1010100010101010101000100010000000101000000010001
1010101010101110101011111011101111101011111010111
1010001010100010101010001000101000101010001010101
1011111010111010101010101110101010101110101010101
1000000010001000101000101010101010101000101010101
1011111111101011101111101010111010101011101110101
1010000000001010001000101000100010101000100010001
1011111110111010111010101110101110101110111011101
1000100010101010100010100010001000000010101000001
1110101010101010101110111011111011111110101111111
1010001000101010000010001000001010000010001000001
1011111111101010111111101111101010111011101011111
1000001000000010100010001000001010001000101000001
1011101011111111101010111010111111101011101011101
1000101000100000001000100010100000001010001010001
1010101110101011111110101110101111111010111110111
1010101010101000101000101000100000100010000010001
1010101010101110101011101111111110101011111011101
1010100010101000101010100000000010101000001000101
1010111110101011101010111111101110101111111110101
1010100000101010000010000000100010100000000000101
1010101111111010111110111110111010111111111111101
1010000000000010000000100000001000000000000000001
1111111111111111111111111111111111111111111111111
