1111111111111111111111111111111111111111111111111
1000100000100010000000100000000010000000000010001
1110101110101011111110101011111010111111111010101
1000101010001000000010101000101010100000000010101
1011101011111111111010101110101010111110111110101
1000001010000000000010000010101010000010000000101
1111111010111111111110111110101011111011111111101
1000001010100000100000100000101000001010000010001
1010101010101010111111101111101111101010111110111
1010100010101010000000001000000000100010100010101
1010101110111011111111111011111110111110101010101
1010101000100010000000100010001000100000001000101
1010111011101110111010101010101111101111111111101
1010100010000010100010101000101000001000100000001
1110101110111010101110111111101011111010111010101
1000101010100010100010000000101000000010001010101
1011101010101111111011111110101111111111101110101
1010001000101000000010000010100000100000100010101
1010111111101010111110111010101010101011111010101
1010001000001010100010001000101010101000001000101
1011101011111011101011101111101010111111101111101
1000001010000000101010100000101010000000001000101
1011111010111110101010111110111011111111101010101
1000100010000010101010000010001010000000101010101
1110101111111110101011111011101010111010101011101
1010001000100000101000001000001010001010100010001
1011111010101111101111101111101011111010111010111
1000000010100000001000101000101000100010001010101
1110111110101111111010101010101110101111111010101
1000100000100000001010100010101000100000000010001
1011111110111111101011111110101011101111111111101
1000100010100000000010001000101010101000100010001
1010101010111011111110101011101010101010101010111
1010001010001000100000100010001010001010101000101
1111111011101110101111111110111010111010101111101
1000001000100010101000000010100010001010100010001
1011101010111011101011111010111011101010111010111
1010001010100000001010001010100010100010100010001
1010111110101111111010111010101110111011101110101
1010000000101000000000100010001000000010001000101
1010111111111011111111101111111011111110111011101
1010100000000010001000001000001000100000100010001
1011101111111110101011111011111110101111111110101
1010001000000000101000100000000000100000100000101
1010111111111011101110101111111111111110101111101
1010100000000010001010100000000000100000101010001
1010101111111110111010111111111111101111101010111
1000001000000000000010000000000000000000001000001
1111111111111111111111111111111111111111111111111
