1111111111111111111111111111111
1010000010000010000000100000101
1011101011101010111110101110101
1000001000101010100010001010101
1111111110101010101011111010101
1000100000101010001010001000101
1011101111101011111010111011101
1000101000001000100010100010001
1010101110111110101110101110101
1010101000100010101000100000101
1010101011101110101010111111101
1010101000100010001010000010001
1010101110111011111010111010111
1010100000100010000010001010001
1110111111101010111111101111101
1000100000001010000010100000001
1010101111101111111010111111111
1010101000001000001010001000001
1011101011101011101011101010101
1000101010001000100010001010101
1010101011111110111110111010101
1010001000000010101000100010101
1011111111101110101010101110101
1010000000101000100010000010101
1010111110101011111111111110101
1000100010100010001000100000101
1111101110111110101010101111101
1000100010100000101010001000101
1011101010111011101011111010101
1000001000000010000010000010001
1111111111111111111111111111111
