1111111111111111111111111111111
1010001000000010001000100010001
1010101111101010101010101010101
1010100000001010100010101000101
1010111111111010111110111111101
1010100010000010000010001000001
1010111010111111111011101011111
1000100010100000000010001000001
1111101010101111111110111011101
1000001010101000001000100010001
1010111110101010111011111010101
1010001000101010001010001010101
1011101011101011101010101110101
1000100010001000100010100000101
1110111111101110111110111111111
1010100000100010001000000000001
1010101110111011101011111111101
1000100010000010001010001000001
1011111011111110111110101011111
1010000010000010100000101010001
1010111110111010101011101010101
1010100010100010101000101000101
1010101010111110101110101111101
1000101000100000101000100010001
1111101111101111111011111010101
1000000000001000000010001000101
1011111111111011111110101111101
1000000010001000101000100000001
1111111010101110101011111111111
1000000000100000100000000000001
1111111111111111111111111111111
