1111111111111111111111111111111
1000000000100000000010001000001
1111111110111110111010101010111
1000000010000000101000101010001
1011111011111111101111101011101
1010001000001000000000101000101
1011101110101110111010101111101
1000001010100010001010101000001
1111101010111011111010101011101
1010001010100000000010101010101
1010111010111111111110101010101
1010001010000010100000101010001
1011101011111010101111101011111
1010000010000010001000101000001
1010111110111110111110101110101
1010100010000010000000100010101
1010101010111011111110111010101
1000101010100010000000100010101
1111101010101011111111101111101
1000001010101010000000101000001
1011111010101110111110101011111
1010000010101000100010001010001
1011111011101011101011111010101
1010001000001000101000100000101
1010101111111110101110101111101
1000100010000010100010000010001
1011111010111010111110111110101
1010000010101010000010100000101
1010111110101011111011101111101
1010000000001000000000001000001
1111111111111111111111111111111
