1111111111111111111111111111111
1000000010000000000010000000101
1111111011101111101010111110101
1000001000101000001010000010001
1011111110111011111011111011111
1000100010000010001000001000001
1010101011111110101111101011101
1010001000000000100010001010101
1011111110111111101110111010101
1000001000100000101000100000101
1011111010101110111011111111101
1010000010100010001010000000001
1010111011111011101010111111101
1010100010000010001010000010001
1010111110111110111011101011101
1010000000100010001000101000101
1011111111111011101110111010111
1000000000000010000010001010001
1111111111111010111011101111101
1000100000000010001010001000101
1010101111111111101010111010101
1010101000000010101010100010001
1110101011111010101110101111101
1000100010001000100010001000101
1010111110101110111011111010101
1010001000100010001000001010001
1011111011111011101011111011111
1010001010001000001000000010001
1010101011101111111111111110101
1000100000000000000000000000101
1111111111111111111111111111111
