1111111111111111111111111111111111111111111111111
1010000000001000100000000010000000001000000000101
1011101111101010101111111010111011111011101110101
1000001000101010101000000010001010001010101000001
1111111011101010101011101111101010101010101111111
1010000000001010001000101000001000100000100000001
1010111111111011111110111011111111111111111011101
1010100000001000100010000010000010000000001000101
1010111110101110111011111110111110111111101111101
1000100000100010000010000000100010001000101000001
1011101111111011111011101010101011101011101011111
1010000000001000001000101010101000001010001010001
1011101111101111101110111010101111111010111010101
1000101000001000100010100010100000100010100000101
1110111011111010111010101111111110111010111110101
1000100010000010000010100010000000100010100010101
1011101110111111111110111010111111101010101010101
1000101000100010000010001010100000001010101010101
1110101011101011101011101010101011111010101011101
1000101000001000001000101010101010001010001000001
1011101110111111111111101010101010101110111111101
1010100010100000100000001010101000100010100000101
1010101011101110101111111010111111101010101110101
1010001000001010001000000010001000101000100010101
1011111110111011111011101111101010111011111010111
1000000010100000100000100000100010001010100010001
1111111010101010111111111110111111101010101111101
1010000010101010001000100000100000101000101000101
1010111110111011101010101111101011101111101010101
1010100010001000101010100000101000100000101010101
1010101011101010101010111110101110111110101110101
1010101000001010100010000010001000100010001000101
1010111111101110111111111011111011101011111010101
1010000000100000100000100010001000001000000010101
1011111110111011111011101110101111111011111011101
1010000010001010001000000000100000000010100010001
1010101111101010101011111111111111111110101110101
1010100000001010101000100000000000101000101000101
1010111111111010101110101111111110101010101011101
1000100000001010101000100010100010100010001010101
1011101111111010101111111010101010101111111010101
1000100000001010100000000010001000101000000010001
1110111111101010111111111110111111111011111110111
1010000000100010000000001000001000001000001010001
1011111110111111111011101111101011101011101011101
1000100000100000001000100010101010101000101000101
1011101111101111101111111010101010101111101011101
1000000000001000000000000010000010000000001000001
1111111111111111111111111111111111111111111111111
