1111111111111111111111111111111
1010000000000000100000000010001
1011111111101110101111101010101
1000100000101000100010101000101
1110101110101111111010101111101
1010100010100000001010100000101
1010111010111111101010111110101
1010100010000010001010001000101
1010101111111010101010111011101
1000100010001000101010001010001
1011101010101111101011101011111
1010001000100000101000001010001
1011111111101110111011111010101
1000001000100010000010001000101
1111101010111110111110101111101
1010001010000010001000100000101
1010111011111011101011111110101
1010000010100010001000100010101
1011111110101111111110101010101
1000001000101000001000101010101
1010101010101011101011101110101
1010100010100010101000100000101
1010111111111110101110111011101
1010000000100000100010001010001
1011111110101110111011101011101
1010001000100010001000001010001
1010101011111011101111111010101
1000101000100010100000001000101
1111101110101110101111111111101
1000000010000000100000000000001
1111111111111111111111111111111
