1111111111111111111111111111111111111111111111111
1010000010000000100000000000100000100000100010001
1010111011101010111111101110111010101010101010111
1000101000101010000000001010001010101010001010001
1111101110101011111111111011101010111011111011101
1000000010101010000000001010001010100010001000101
1011101110101010111111101010111010101110101110101
1000100010101010000000101010000010001000101010101
1110111010101011111110101011111111111011101010101
1010001000101000000010101000000000000010000010001
1011101111111110111110101111101110111110111111101
1000101000001000100000100010001010100010100000101
1010101011101011101111111010111010101011101011101
1010101010101010001000100010100000101010001000001
1011101010101010111011101110111011101010111111111
1000001010001010100010001000001010001000100000001
1011111010111010111010111011101110111111111011101
1010000010100000000010001000101000100010000010001
1010111010111111101111101111101011101011101111111
1010101010100010001000100000101010001000100000001
1010101010101011111010111110101010111110101111101
1010001010101000000010000000101000100000101000001
1011101010101111111111111111101111101111111011111
1010001010001000000010000010000000001000001000001
1011101011111011111010101110111111111110101111101
1000101010001010100010100000100000000000100000101
1110101010101010101110111111101111111011111110101
1010101010100000100010101000001000100010100010001
1010101011111110111010101011111010101110101011101
1000101010000010100010100000100010001010001000101
1011111010111010101110111111101111111010111011101
1010001010100010100000001000101010001000101000001
1010101010101111111111101010101010101011101111111
1010101000100000000010001010001010101010000010001
1010101111111111101011101011111010101010111011101
1000100000100000101000100010000010101000100010001
1111111110101110111110111110101110101111101110101
1000000010001000100000100000101000100000101000101
1011101011111011101111111110101011101011101011101
1010001000001000001000000000101000101010001000101
1010111111101111111111101011111110101110111110101
1010100000101000000000001010000000100010000000101
1110101110101010111111111110111111101011111111101
1000100010001010100000000010001000101000001000001
1011111011111110101111111010111010111111101011111
1010000000000000100010000010100010000000001000001
1011111111111111111010111110101111111111111111101
1000000000000000000010000000100000000000000000001
1111111111111111111111111111111111111111111111111
