1111111111111111111111111111111
1000100000000000100010000000001
1110111011111010101011101110101
1010001000100010001000101000101
1011101111101111111110111011101
1000100000001000000010000010001
1010111111111111101011111110111
1010000000001000001010001000101
1110111111101011111011101011101
1000100000100010001010001000001
1011111011111110101010101111101
1000001010000000101000100010101
1011101010111111101111111010101
1010001000100000100000000000101
1110111011101010111111111111101
1000100010001010001000000010001
1011101111111011101011111110111
1000100000000010100010000010101
1010111111111110111010111010101
1010100000000000000010100010101
1110101111111111111010101010101
1000101000100000001010101010101
1011111010101111101110101010101
1000000010001010001000101010101
1011111111111010111011101010101
1000001000000010001010101010001
1111101011111111101010101011101
1010001000000000100010101000101
1010111111111110111110101111101
1000000000000000000000100000001
1111111111111111111111111111111
