1111111111111111111111111111111111111111111111111
1000000000000000001000001000000010001000000000001
1111111111111111101110101110111010101110111110111
1010000000000000100000100000101000100010100010001
1010111011111111111111111111101111111010101111101
1010101000001000000010100000100000100010001000101
1010101111101010111010101110101110101111111010101
1000101000100010100000101000100010001000000010001
1011101010111110101111101011111011111010111111101
1010000010001000100010001000100010000010100000101
1011111111101011111010111110101111111110111010101
1010000000101010100010000010100000000000100010101
1010111110101010101111111010111111111111101111101
1000101000101010000010000010100000100000001000001
1111101011101011111110111110101010101011111011111
1010000010001000100000100010001010101000001010001
1010111110101110101111111011111011101111101010101
1010001000100010001000000010001010001010001010101
1011101010111011111011111010111010111010101011101
1000101010101000100010001010100010100010101000001
1110101010101110101011101010101010111010111111101
1000101010100010101000101010101010000010000010001
1010101110101010111110101010101011111011101110111
1010100000101010000000101010101000001000100000101
1011111111101011111111101010101111111110111111101
1000000010001010000000100010100010000010001000001
1010111010111010101011101110111010101111101011101
1010100010100010101010001000001010100010001010001
1110101110101110101010111111101010111010111010111
1000101000100000101010000000001010101000101010001
1011111011111111101010111111111010101111101011101
1000000010100000001010100000100010001000000010001
1011111110101111111010101110101011101111111110101
1000100000101010000010101000001010001000100010101
1110111011101010111110101111101110111010101010101
1010100010001010100010101000101000100010001000101
1010101010111010101110101010111011111011111011111
1000001010100000001000100010100010000010001010001
1011111110101111111011111110101110111010101110101
1000100000100010001010000010001000100010101000101
1110101111101110101010111011111110111110101011101
1010100010001000101010001000000010100000101000101
1010111011111011101011111011111010101111101011101
1000101000100010100010000010100010000000101010001
1011101110101110111110111110101111111111101010101
1000100010101000100000001000100000001000100010101
1110101010101010111111101010111111101010111110101
1000001010000010000000001010000000000010000000101
1111111111111111111111111111111111111111111111111
